Nettie	female
Odelia	female
Atalanta	female
Harlie	female
Kerry	male
Darci	female
Cati	female
Stephine	female
Dorri	female
Elvin	male
Jaymee	female
Sharla	female
Blinni	female
Sena	female
Trent	male
Jeannie	female
Teresina	female
Adah	female
Adriaens	female
Dottie	female
Corenda	female
Zalman	male
Jean-Luc	male
Tobit	male
Hart	male
Yardley	male
Ailey	female
Violet	female
Tommi	female
Davida	female
Corette	female
Boris	male
Lian	female
Prasad	male
Lacie	female
Norean	female
Alexandrina	female
Shoshana	female
Stefa	female
Kellyann	female
Carlene	female
Isadora	female
Maribeth	female
Inge	female
Quintana	female
Taryn	female
Simeon	male
Caprice	female
Gwynne	female
Jany	female
Clarisse	female
Amata	female
Ashley	female
Ali	male
Della	female
Marena	female
Noellyn	female
Idelle	female
Crissie	female
Gian	male
Whitman	male
Jocelyn	female
Torey	female
Bo	male
Mireille	female
Jefferey	male
Marlie	female
Courtney	male
Leiah	female
Dinnie	female
Shantee	female
Sophia	female
Edie	male
Jacques	male
Christie	female
Iolanthe	female
Aurelia	female
Nolana	female
Merlina	female
Lovell	male
Marilyn	female
Dominique	male
Bambi	female
Lonni	female
Annalisa	female
Isabel	female
Bamby	female
Kelley	female
Millisent	female
Kaster	female
Melody	female
Selie	female
Vale	female
Jerrold	male
# 2940 names	male
Lisandra	female
Bill	male
Titus	male
Chelsea	female
Tory	female
Catharine	female
Thebault	male
Poppy	female
Anabelle	female
Quincy	male
Dorine	female
Shelley	female
Audra	female
Sherlocke	male
Brett	male
Chicky	female
Blinnie	female
Genni	female
Gilberto	male
Ashleigh	female
Augustus	male
Partha	male
Darrick	male
Kellen	female
Andromeda	female
Lesly	female
Kirbee	female
Robbyn	female
Steffane	female
Meier	male
Nicholas	male
Ortensia	female
Kendre	female
Suellen	female
Daloris	female
Christine	female
Johan	male
Sherye	female
Annmarie	female
Mellisa	female
Allyn	male
Davide	male
Goldy	female
Alfonse	male
Shara	female
Correy	female
Cybelle	female
Garcon	male
Filip	male
Darsie	female
Ernie	male
Delia	female
Robb	male
Goldina	female
Connie	female
Ilsa	female
Abdulkarim	male
Isahella	female
Hercule	male
Tiphany	female
Yard	male
Ulrica	female
Lianne	female
Tre	male
Alleen	female
Griff	male
Darya	female
Ranice	female
Ansel	male
Heida	female
Maria	female
Melloney	female
Sheeree	female
Locke	male
Reeta	female
Cordey	female
Kia	female
Daniela	female
Mureil	female
Sollie	male
Lorianne	female
Barbey	female
Julianna	female
Toddie	male
Tildy	female
Tia	female
Jillian	female
Angie	male
Claire	female
Sonny	female
Myron	male
Raynell	female
Alma	female
Flor	female
Breena	female
Muhammad	male
Sher	female
Nikos	male
Brit	female
Lanie	female
Halie	female
Leona	female
Sancho	male
Fredrika	female
Elisa	female
Gilda	female
Winn	male
Marlyn	female
Harman	male
Misha	female
Bennet	male
Diena	female
Nataline	female
Aidan	female
Auria	female
Fayre	female
Bethina	female
Westleigh	male
Gav	male
Griffith	male
Kittie	female
Tarrance	male
Stormi	female
Aubrie	female
Darbie	female
Shauna	female
Nessie	female
Somerset	male
Shoshanna	female
Irma	female
Daffi	female
Michele	male
Rosina	female
Mab	female
Isa	male
Elizabeth	female
Eddy	female
Brianna	female
Julietta	female
Kelcie	female
Aina	female
Conan	male
Pierre	male
Di	female
Bobina	female
Alberto	male
Janet	female
Cosmo	male
Melly	female
Ariadne	female
Vinnie	female
Ida	female
Patrice	female
Vivie	female
Hermione	female
Stefan	male
Daffy	female
Carole	female
Roy	male
Gretna	female
Arvy	male
Christabel	female
Chad	male
Allah	male
Helen	female
Peggy	female
Christean	female
Orelia	female
Matthiew	male
Brian	male
Osborne	male
Dean	male
Carlina	female
Giraldo	male
Joleen	female
Cheryl	female
Letti	female
Ginger	female
Noni	female
Cassandry	female
Steffi	female
Daren	male
Nahum	male
Sarita	female
Odetta	female
Catie	female
Shurlocke	male
Josy	female
Lorain	female
Carry	female
Leodora	female
Meris	female
Loralee	female
	male
Anatola	female
Edithe	female
Vena	female
Winton	male
Marcellus	male
Molly	female
Janeen	female
Archy	male
Wyatan	male
Rutger	male
Fanni	female
Dorothy	female
Elga	female
Becka	female
Patrik	male
Betteann	female
Laurance	male
Aeriel	female
Sergio	male
Jan	male
Neddy	male
Carolyn	female
Laetitia	female
Andra	female
Christi	female
Terencio	male
Anabella	female
Levi	male
Ethelyn	female
Clea	female
Stanford	male
Steven	male
Lusa	female
Holly	female
Callida	female
Haleigh	female
Gayle	female
Patti	female
Debby	female
Lacy	female
Isaak	male
Lynde	female
Ambros	male
Kayley	female
Karla	female
Nicoline	female
Luke	male
Burgess	male
Guillaume	male
Hadley	male
Tiffie	female
Neysa	female
Roddy	male
Randa	female
Pauli	female
Sheffie	male
Lamar	male
Minda	female
Morgen	female
Lisette	female
Thalia	female
Briana	female
Rik	male
Sigrid	female
Taylor	male
Starr	female
Arlee	female
Marion	female
Corky	male
Nevins	male
Grace	male
Mirabella	female
Wesley	male
Ermentrude	female
Eric	male
Rianon	female
Dryke	male
Dot	female
Enid	female
Roice	male
Jewell	female
Maya	female
Roscoe	male
Sax	male
Ericka	female
Solly	male
Teresa	female
Hortensia	female
Ruthe	female
Vincent	male
Bonnee	female
Layton	male
Eugine	female
Artie	male
Alexandra	female
Lanette	female
Wally	female
Darlene	female
Teodoro	male
Anton	male
Faustine	female
Rora	female
Wendeline	female
Fergus	male
Theodore	male
Kacy	female
Rhetta	female
Kata	female
Toby	male
Frederic	male
Cordie	female
Friederike	female
Laurent	male
Byram	male
Blondy	female
Valentin	male
Sue-elle	female
Terrianne	female
Vina	female
Zachariah	male
Ricky	female
Gary	male
Shayne	female
Hasty	male
Myrtle	female
Layney	female
Andriana	female
Eada	female
Othello	male
Karim	male
Saunders	male
Jessika	female
Brandy	female
Grete	female
Prent	male
Euphemia	female
Sal	male
Belia	female
Tate	female
Nero	male
Benedicta	female
Veda	female
Gallagher	male
Phillip	male
Mitch	male
Carlos	male
Evan	male
Penelopa	female
Hanna	female
Carmella	female
Caresse	female
Dusty	female
Traci	female
Cornelius	male
Aigneis	female
Ann	female
Hamid	male
Cobby	male
Ilyse	female
Fidelity	female
Jodie	female
Rickard	male
Cindy	female
Roni	male
Joell	female
Minny	female
Abbie	male
Rasia	female
Georgette	female
Petrina	female
Carleigh	male
Cyb	female
Tatiania	female
Lex	male
Magda	female
Kylynn	female
Vinod	male
Danny	male
Robina	female
Nicolas	male
Kary	female
Richmond	male
Saunderson	male
Cam	male
Daniele	female
Genevieve	female
Pearce	male
Dian	female
Odell	male
Robin	male
Luana	female
Spence	male
Lena	female
Darice	female
Hyacinth	female
Kim	male
Horatio	male
Ashly	female
Timothea	female
Thurston	male
Ruth	female
Timmie	female
Fidela	female
Roz	female
Nicolina	female
Chance	male
Zora	female
Elbert	male
Romonda	female
Darsey	female
Dionis	female
Adel	female
Leontyne	female
Hersch	male
Thornton	male
Latashia	female
Hyacinthie	female
Harv	male
Roarke	male
Zahara	female
Kingston	male
Rufus	male
Aloysius	male
Ardis	female
Nathalie	female
Harmony	female
Emmery	male
Melonie	female
Ahmet	male
Munmro	male
Velma	female
Oriana	female
Catrina	female
Kristi	female
Eran	female
Hadrian	male
Zedekiah	male
Carroll	male
Elliot	male
Gussy	female
Sibyl	male
Carli	female
Ibrahim	male
Marcel	male
Sabra	female
Auguste	female
Irina	female
Barbara-Anne	female
Rachele	female
Elly	female
Reggie	female
Clarey	female
Corly	female
Denise	female
Rissa	female
Erhart	male
Zeke	male
Theressa	female
Edna	female
Rafe	male
Aguinaldo	male
Rahel	female
Monique	female
Meta	female
Teodorico	male
Jeremy	male
Scotti	male
Carlin	male
Teddy	female
Melba	female
Vasili	male
Obie	male
Deny	female
Evey	female
Jinny	female
Trescha	female
Sofia	female
Vivyan	female
Ulrich	male
Deeann	female
Tiffanie	female
Effie	female
Prasun	male
Dionis	male
Mahalia	female
Elana	female
Sebastian	male
Belle	female
Ruthi	female
Teddi	female
Alyce	female
Phip	male
Andi	female
Letitia	female
Jasmine	female
Karel	female
Berna	female
Grace	female
Mariette	female
Delila	female
Wandie	female
Ileana	female
Allison	female
Morrie	male
Issy	female
Merrily	female
Madelaine	female
Diamond	female
Engracia	female
Nissa	female
Clio	female
Thorsten	male
Ronnica	female
Dennie	male
Blisse	female
Mufinella	female
Alain	male
Lenette	female
Elbertine	female
Sybille	female
Coralie	female
Berte	female
Mariel	female
Laverna	female
Rogers	male
Cora	female
Nicolle	female
Sam	female
Penny	female
Heathcliff	male
Hally	female
Erny	male
Marcelle	female
Agnesse	female
Abagail	female
Darren	male
Arie	male
Tynan	male
Genvieve	female
Lars	male
Dan	male
Pamelina	female
Harrold	male
Sampson	male
Bert	female
Giovanna	female
Vonny	female
Moira	female
Idaline	female
Carlita	female
Gerda	female
Almeta	female
Mercy	female
Edgar	male
Roxanne	female
Cletus	male
Linnet	female
Netty	female
Jordan	female
Glad	female
Jorry	female
Catherine	female
Valina	female
Renado	male
Orsa	female
Elbertina	female
Louella	female
Katharine	female
Morganica	female
Stan	male
Elvera	female
Jorrie	female
Francine	female
Rees	male
Adrien	female
Shelba	female
Sherill	female
Salvatore	male
Salomo	male
Hatti	female
Ebony	female
Roch	female
Kingsley	male
Francoise	female
Manon	female
Diannne	female
Helena	female
Ilise	female
Neal	male
Ceciley	female
Kessia	female
Rollins	male
Terry	female
Sondra	female
Anni	female
Tab	male
Thornie	male
Deane	male
Meggie	female
Cherlyn	female
Stacey	female
Luce	male
Town	male
Lynette	female
Stevy	male
Crawford	male
Gusella	female
Katina	female
Sheelah	female
Garwin	male
Joann	female
Fey	female
Ayn	female
Emerson	male
Zondra	female
Florella	female
Alyssa	female
Broddy	male
Ruthy	female
Kaitlyn	female
Malkah	female
Zacharie	male
Babara	female
Hillary	female
Merrick	male
Tobie	male
Johannes	male
Rudyard	male
Verile	female
Ellynn	female
Nikkie	female
Jeannette	female
Etheline	female
Michaeline	female
Anne	female
Albrecht	male
Carolie	female
Ophelie	female
Addie	male
Alfonzo	male
Natassia	female
Kimmie	female
Ash	male
Maxie	male
Thorvald	male
Joey	male
Kelsi	female
Maegan	female
Virgil	male
Billy	male
Wanda	female
Terrie	female
Whitney	female
Guthrie	male
Nova	female
Ramonda	female
Piet	male
Halli	female
Arden	female
Leone	female
Vinita	female
Lenora	female
Sergei	male
Helga	female
Han	male
Kesley	female
Valaree	female
Gustav	male
Lorrie	female
Wilt	male
Ingmar	male
Bob	male
Gabbey	female
Margareta	female
Kory	male
Len	male
Phineas	male
Pepi	female
Andreana	female
Viv	female
Teodora	female
Murray	male
Harriett	female
Regan	female
Vale	male
Euclid	male
Helaine	female
Sarge	male
Ebeneser	male
Kalli	female
Reeva	female
Collete	female
Tibold	male
Erasmus	male
# List of common female names.	female
Gerladina	female
Marsha	female
Daniel	female
Lindie	female
Lauretta	female
Blanch	female
Elliott	male
Hadleigh	male
Erwin	male
Marketa	female
Doll	female
Dulcy	female
Adelice	female
Ediva	female
Kenny	male
Brendan	male
Feliza	female
Cappella	female
Lemuel	male
Almira	female
Andee	female
Zorina	female
Paulie	female
Flori	female
Lorena	female
James	male
Wylie	male
Corri	female
Rita	female
Demetri	male
Merna	female
Alisha	female
Bruce	male
Carlie	male
Lauraine	female
Filipe	male
Trude	female
Royal	male
Johnny	male
Joannes	female
Waite	male
Gwenny	female
Catina	female
Kevan	male
Federica	female
Laura	female
Becky	female
Jereme	male
Dorthea	female
Mohan	male
Lula	female
Margarethe	female
Gabbie	female
Dimitri	male
Crysta	female
Jordana	female
Hayden	male
West	male
Leese	female
Willy	female
Lise	female
Kali	female
Gussie	female
Jeane	female
Eulalie	female
Jacklyn	female
Caryl	female
Lanita	female
Jimbo	male
Keren	female
Ellissa	female
Davey	male
Melisent	female
Nancey	female
Elberta	female
Niki	female
Yevette	female
Gardiner	male
Yvette	female
Jaclyn	female
Bea	female
Felicio	male
Grove	male
Brook	female
Rosalind	female
Winni	female
Giovanni	male
Ansell	male
Rosanne	female
Mahmoud	male
Cassi	female
Roxana	female
Essy	female
Kaila	female
Emmeline	female
Timmy	male
Melinda	female
Phyllis	female
Lonny	male
Abigail	female
Nanni	female
Riane	female
Giffy	male
Aurelie	female
Leanora	female
Kevyn	female
Ainslee	female
Oliy	female
Carolee	female
Elisabeth	female
Henrik	male
Eleonore	female
Lucille	female
Jess	female
Donella	female
Anurag	male
Brodie	male
Jedediah	male
Laurens	male
Fernande	female
Ford	male
Iain	male
Clark	male
Niven	male
Alina	female
Claresta	female
Quentin	male
Morley	male
Karl	male
Lani	female
Jeremiah	male
Nisa	female
Latisha	female
Rainer	male
Windham	male
Nonie	female
Dwayne	male
Aurilia	female
Hollis	male
Shay	male
Merell	male
Tiffy	female
Gordan	male
Julian	male
Gisella	female
Susi	female
Cathleen	female
Del	male
Daryl	female
Andy	male
Ilyssa	female
Truda	female
Jonis	female
Marylinda	female
Britney	female
Greer	female
Connie	male
Shea	female
Demosthenis	male
Ikey	male
Zola	female
Wilma	female
# Thanks to Bill.Ross for about 1000 additional names.	female
Skelly	male
Kris	female
Vicki	female
Gayleen	female
Guy	male
Nissie	female
Lorianna	female
Nathaniel	male
Melisa	female
Robbie	male
Bronson	male
Georgiamay	female
Dynah	female
Arly	female
Ivy	female
Westbrooke	male
Katy	female
Blanche	female
Joana	female
Rosella	female
Pammi	female
Charlot	female
Sophi	female
Sharlene	female
Apollo	male
Stephie	female
Anne-Mar	female
Hester	female
Bertrand	male
Hanny	female
Lyndy	female
Derrek	male
Dorolice	female
Marj	female
Winna	female
Lindi	female
Tim	male
Sandy	female
Heath	female
Osbert	male
Jan	female
Miles	male
Husein	male
Keeley	female
Cooper	male
Moyra	female
Hyacinthe	female
Cherie	female
Danelle	female
Desmund	male
Brooke	male
Celia	female
Reynold	male
Umberto	male
Gustave	male
Fifi	female
Karoly	female
Marline	female
Jeanette	female
Daisi	female
Jilli	female
Tedie	male
Jeannine	female
Gayle	male
Modestia	female
Secunda	female
Alonso	male
Priscella	female
Davie	male
Codee	female
Cass	male
Adele	female
Felecia	female
Josee	female
Carita	female
Ted	male
Erin	female
Consuelo	female
Sinead	female
Abbey	female
Kim	female
Rick	male
Jobey	female
Bernelle	female
Tabina	female
Pet	female
Leland	female
Allianora	female
Stormy	female
Frederick	male
Phaedra	female
Adger	male
Bren	female
Karia	female
Karyn	female
Jonie	female
Constantine	male
Lonna	female
Rycca	female
Alonzo	male
Maiga	female
Marc	male
Jaquith	female
Fania	female
Alyson	female
Mairead	female
Linoel	male
Pepe	male
Netta	female
Hestia	female
Melony	female
Clyde	male
Tatiana	female
Daffy	male
Natalia	female
Apostolos	male
Torin	male
Yetta	female
Lacey	female
Rutledge	male
Silva	female
Lamb	female
Clint	male
Rubin	male
Marlon	male
Fonsie	male
Filippa	female
Lizzie	female
Katherina	female
Francesmary	female
Natalya	female
Carola	female
Viviyan	female
# Copyright (c) January 1991 by Mark Kantrowitz.	male
Ferdinanda	female
Kenyon	male
Illa	female
Shaun	female
Adeline	female
Gerrie	female
Sylvia	female
Franklyn	male
Doe	female
Tremain	male
Roslyn	female
Rhonda	female
Debora	female
Gabriellia	female
Leonelle	female
Agathe	female
Fanchette	female
Job	male
Daniel	male
Rourke	male
Casper	male
Geralda	female
Leora	female
Corwin	male
Witold	male
Rose	female
Candida	female
Glenna	female
Margery	female
Kordula	female
Elwira	female
Sven	male
Marchall	male
Tessa	female
Shimon	male
Maggie	female
Cinnamon	female
Jori	female
Nettle	female
Maisie	female
Mina	female
Wilbur	male
Vernen	male
Tansy	female
Ruddie	male
Rheta	female
Stavros	male
Kylen	female
Cara	female
Elaina	female
Gillie	female
Beauregard	male
Sorcha	female
Tonie	female
Katya	female
Susan	female
Lavena	female
Bettye	female
Gwennie	female
Grayce	female
Samuella	female
Quillan	male
Louie	male
Hermon	male
Herminia	female
Kassi	female
Karleen	female
Giraud	male
Sharna	female
Tyson	male
Paulo	male
Betty	female
Clementina	female
Dylan	male
Stace	female
Jacqueline	female
Gillian	female
Modesta	female
Darleen	female
Latrena	female
Eugen	male
Fabrianne	female
Jordain	female
Dasi	female
Rosie	female
Stanfield	male
Jonathan	male
Emelda	female
Chen	male
Lira	female
Rosemonde	female
Gus	male
Lev	male
Burke	male
Chan	male
Oralla	female
Jodi	male
Lisa	female
Kelly	female
Bobette	female
Nathan	male
Winifield	male
Perry	female
Kaitlin	female
Piper	female
Dareen	female
Sherlock	male
Dawson	male
Lilli	female
Danita	female
Charlotta	female
Mela	female
Averil	male
Cobb	male
Nelia	female
Ashlee	female
Isaac	male
Maryl	female
Lem	male
Edi	female
Jacynth	female
Hanan	male
Stevie	male
Montague	male
Wandis	female
Rodolfo	male
Paddy	male
Tawnya	female
Jane	female
Liam	male
Freda	female
Neala	female
Shelton	male
Francisco	male
Freemon	male
Leticia	female
Pearla	female
Camille	female
Justin	female
Buster	male
Concordia	female
Kee	female
Henrique	male
Meredithe	female
Jandy	female
Bartlet	male
Gaston	male
Davon	male
Fawne	female
Sandi	female
Sherline	female
Uli	male
Basil	male
Pieter	male
Rory	male
Cindie	female
Staci	female
Cordula	female
Caresa	female
Pietro	male
Lila	female
Worth	male
Rebecca	female
Karrah	female
Irene	female
Dyanne	female
Lyndel	female
Lida	female
Bishop	male
Florida	female
Mariellen	female
Harrie	female
Madeline	female
Mitchell	male
Mechelle	female
Murdoch	male
Othilia	female
Tiana	female
Leigh	male
Myrna	female
Prissie	female
Kirby	female
Gretel	female
Lucas	male
Napoleon	male
Reg	male
Luciana	female
Reece	male
Idette	female
Shela	female
Horatius	male
Ulberto	male
Candice	female
Deni	female
Koral	female
Meira	female
Wald	male
Zachery	male
Brandie	female
Ike	female
Ram	male
Marcello	male
Carl	male
Bobby	female
Blair	female
Woodrow	male
Darell	female
Marie	female
Vin	male
Camel	female
Tedrick	male
Bekki	female
Valera	female
Giancarlo	male
Lilith	female
Vaughan	male
Tabatha	female
Albertine	female
Nicky	male
Faun	female
Ileane	female
Jemimah	female
Nickolas	male
Kirstyn	female
Hale	male
Bernita	female
Brina	female
Giorgia	female
Kameko	female
Mirabel	female
Margarete	female
Milli	female
Garey	male
Merissa	female
Shurlock	male
Danna	female
Billi	female
Ivan	male
Clancy	male
Ray	female
Maxi	female
Trista	female
Wilfred	male
Maureen	female
Asia	female
Aimee	female
Shamit	female
Kane	male
Shanna	female
Ehud	male
Valeria	female
Lucretia	female
Mahala	female
Henrie	male
Aldus	male
Drake	male
Morganne	female
Ada	female
Sterne	male
Alec	male
Grethel	female
Rowland	male
Elihu	male
Cristen	female
Garvy	male
Rozanne	female
Sheffield	male
Kellie	female
Joan	female
Marieann	female
Cassie	female
Mathew	male
Rosemarie	female
Cosetta	female
Nissy	female
Winonah	female
Hermia	female
Doroteya	female
Em	female
Mirabelle	female
Cob	male
Archie	male
Griswold	male
Siobhan	female
Aindrea	female
Marcela	female
Betsey	female
Georgiana	female
Shay	female
Chaddie	male
Jennee	female
Nevsa	female
Uri	male
Jerrilee	female
Katti	female
Nani	female
Molli	female
Erena	female
Olia	female
Karee	female
Isadore	male
Odelinda	female
Bridget	female
Phaidra	female
Martino	male
Isadore	female
Danice	female
Frederica	female
Bennett	male
Flower	female
Matilda	female
Laurianne	female
Wang	male
Appolonia	female
Keslie	female
Lauryn	female
Jaquelin	female
Vernor	male
Brice	male
Kalina	female
Maribel	female
Baron	male
Clifford	male
Sascha	female
Jobi	female
Wallas	male
Lizzy	female
Dianemarie	female
Dirk	male
Jessie	female
Martguerita	female
Isabelita	female
Abbey	male
Kissiah	female
Ernesto	male
Sherie	female
Ranna	female
Nert	female
Ben	male
Raynor	male
Kiersten	female
Tierney	female
Margalit	female
Arabel	female
Leorah	female
Larine	female
Rosalyn	female
Filide	female
Shawnee	female
Iona	female
Alena	female
Tori	female
Fairfax	male
Bradley	male
Aubree	female
Calley	female
Lurleen	female
Garrot	male
Ichabod	male
Bevvy	female
Yettie	female
Fons	male
Meade	male
Sergent	male
Randy	male
Thorny	male
Bryon	male
Rice	male
Sheppard	male
Larina	female
Marguerite	female
Cherilynn	female
Rochelle	female
Mathilda	female
Weylin	male
Chane	male
Fremont	male
Gilly	female
Iolande	female
Jake	male
Washington	male
Halette	female
Rodrique	male
Row	female
Randell	male
Lynn	female
Darby	male
Celle	female
Tobey	female
Wilmer	male
Vinni	female
Sibley	female
Coretta	female
Welch	male
Brigitta	female
Clementine	female
Sharyl	female
Edward	male
Becki	female
Carmen	female
Mathias	male
Riki	female
Regine	female
Jacintha	female
Malvina	female
Madlin	female
Felipe	male
Silvano	male
Mahmud	male
Nikolai	male
Marius	male
Gena	female
Timmie	male
Adair	male
Gerti	female
Darcy	female
Joni	female
Cary	male
Nerissa	female
Kimberli	female
Betsy	female
Mattheus	male
Hiralal	male
Wendie	female
Darcee	female
Teena	female
Sacha	female
Claudette	female
Rochell	female
Grazia	female
Nela	female
Mattias	male
Clovis	female
Muffin	female
Bay	male
Oliver	male
Millie	female
Felicity	female
Mable	female
Celestyn	female
Willette	female
Douglas	male
Luci	female
Hyacinthia	female
Consuela	female
Malissa	female
Gregory	male
Manya	female
Judith	male
Renaldo	male
Tann	male
Andrew	male
Eddie	male
Austin	male
Tedmund	male
Rodi	female
Xylia	female
Win	male
Lotte	female
Tiebold	male
Tammy	male
Reese	male
Jo Ann	female
Lou	male
Winthrop	male
Algernon	male
Lucia	female
Janine	female
Linzy	female
Janeta	female
Mellissa	female
Merilyn	female
Ellis	male
Simonne	female
Sidoney	female
Easton	male
Pete	male
Fidel	male
Gibb	male
Bubba	male
Madeleine	female
Olivie	female
Manfred	male
Magnus	male
Marcelia	female
Corey	female
Juliana	female
Ellene	female
Leanne	female
Desaree	female
Jimmy	male
Lethia	female
Eduard	male
Vail	male
Bridgett	female
Dom	male
Fulvia	female
Kelsey	female
Jorey	female
Tye	male
Chaddy	male
Percival	male
Nealy	male
Dyan	female
Melli	female
Celestyna	female
Katey	female
Wynton	male
Nathanael	male
Joceline	female
Zeus	male
Rodney	male
Cordelia	female
Kam	male
Zary	male
Umeko	female
Joane	female
Licha	female
Devina	female
Towny	male
Laryssa	female
Enriqueta	female
Milissent	female
Rhianna	female
Quintin	male
Emmanuel	male
Gerrilee	female
Sansone	male
Margit	female
Jen	female
Kelley	male
Bonnie	female
Aron	male
Onlea	female
Brad	male
Melanie	female
Prisca	female
Datha	female
Davina	female
Christan	female
Meridel	female
Deryl	male
Anna-Maria	female
Tandi	female
Immanuel	male
Veronike	female
Jewelle	female
Hermy	male
Dorice	female
Elke	female
Paolo	male
Michal	male
Vickie	female
Mella	female
Clarabelle	female
Lorri	female
Rafaelia	female
Mindy	female
Nike	female
Lilia	female
Shandy	female
Lynea	female
Conrad	male
Will	male
Nathanil	male
Samaria	female
Tome	male
Martie	male
Bobbette	female
Leela	female
Boyd	male
Klarrisa	female
Forest	male
Dolley	female
Brenda	female
Sunny	male
Phedra	female
Marie-Jeanne	female
Barry	female
Fleur	female
Scarface	male
Page	female
Pearl	female
Claus	male
Drew	male
Swen	male
Dena	female
Rosabelle	female
Tony	female
Nita	female
Waldemar	male
Guthry	male
Bessy	female
Clem	male
Russ	male
Vibhu	male
Rozalin	female
Jaine	female
Jordon	male
Libbi	female
Harwell	male
Leola	female
Joaquin	male
Carlisle	female
Carmine	male
Clarine	female
Jephthah	male
Leonidas	male
Tessi	female
Kristal	female
Constancia	female
Jesse	male
Annnora	female
Antony	male
Liz	female
Mallory	female
Ethelred	male
Novelia	female
Frances	female
Minetta	female
Fortune	female
Norma	female
Wylma	female
Cordelie	female
Cathie	female
Blake	female
Alysa	female
Josephus	male
Theresita	female
Tami	female
Giles	male
Julie	male
Albertina	female
Beret	female
Ciel	female
Tan	male
Malinda	female
Carlie	female
Phebe	female
Dorolisa	female
Jasmina	female
Britni	female
Marylin	female
Beau	female
Kettie	female
Danny	female
Godfry	male
Constantine	female
Lona	female
Roxine	female
Renae	female
Flo	female
Kaycee	female
Harrison	male
Quiggly	male
Ursola	female
Eleni	female
Loraine	female
Margurite	female
Evelyn	male
Shandie	female
Emmy	female
Gabriello	male
Alica	female
Jakob	male
Lukas	male
Collin	male
Odette	female
Adey	female
Erastus	male
Shaylyn	female
Meir	male
Baxter	male
Kissee	female
Raquela	female
Jessamine	female
Beau	male
Berni	female
Leigh	female
Billie	female
Aub	male
Beckie	female
Candide	female
Theresa-Marie	female
Corny	female
Anya	female
Duncan	male
Sharron	female
Orbadiah	male
Marya	female
Lorna	female
Fredelia	female
Lorine	female
Etienne	male
Hamish	male
Sibella	female
Kamillah	female
Morissa	female
Audrie	female
Seth	male
Cristin	female
Candis	female
Etta	female
Julee	female
Sukey	female
Elmer	male
Flore	female
Ainslie	female
Danyette	female
Broderick	male
Ric	male
Marina	female
Chrissy	male
Lazarus	male
Marshall	male
Erl	male
Neile	female
Antoine	male
Peyter	male
Florina	female
Claude	female
Shawn	male
Jill	female
Tim	female
Nadiya	female
Stuart	male
Stirling	male
Cathrine	female
Carmelia	female
Pattie	female
Terri-Jo	female
Ronica	female
Baird	male
Earle	male
Halvard	male
Fletcher	male
Henri	male
Camila	female
Kristyn	female
Amity	female
Randene	female
Quinta	female
Jolee	female
Muriel	female
Calvin	male
Rochester	male
Bearnard	male
Greta	female
Nolie	female
Christabella	female
Orrin	male
Christiana	female
Thelma	female
Sloane	male
Darwin	male
Sofie	female
Mariann	female
Mada	female
Elton	male
Rufe	male
Tammie	male
Sari	female
Brittan	female
Thorstein	male
Leonid	male
Fanya	female
Haley	male
Eveleen	female
Rosmunda	female
Fawnia	female
Wilow	female
Arlo	male
Kamila	female
Kay	female
Temp	male
Beatrice	female
Beck	male
Jobina	female
Suzetta	female
Engelbart	male
Benn	male
Marys	female
Davidson	male
Veronica	female
Barbi	female
Damaris	female
Ardyth	female
Madelena	female
Madalena	female
Cosette	female
Gilbert	male
Maude	female
Dixie	female
Stanleigh	male
Norah	female
Florencia	female
Denys	female
Sophie	female
Ashley	male
Arlen	female
Nevil	male
Zorro	male
Ellyn	female
Nicol	female
Anjanette	female
Frank	male
Anastassia	female
Rozamond	female
Mignonne	female
Thaddus	male
Cat	female
Ludvig	male
Brandise	female
Milka	female
Nickie	male
Merline	female
Carina	female
Dee	female
Amelita	female
Arline	female
Loren	female
Vitia	female
Andriette	female
Hall	male
Julie	female
Nessi	female
Perl	female
Lucila	female
Alison	female
Georgeta	female
Roberta	female
Roddie	male
Siward	male
Levy	male
Gamaliel	male
Tedd	male
Lorita	female
Rebekkah	female
Annecorinne	female
Derrick	male
Cybal	female
Alayne	female
Tiertza	female
Bartholomew	male
Wynne	female
Orelle	female
Rosalynd	female
Niles	male
Sherrie	female
Allis	female
Jessalin	female
Cammy	female
Serena	female
Lauren	female
Harrietta	female
Cy	male
Bird	female
Art	male
Isidore	male
Minerva	female
Odessa	female
Barrie	female
Lenore	female
Paco	male
Kathlin	female
Gloriana	female
Glynis	female
Cristie	female
Wes	male
Andie	male
Venita	female
Myna	female
Dale	male
Haskell	male
Kristen	female
Julio	male
Hagen	male
Caty	female
Shaw	male
Kimberlyn	female
Klee	male
Cesar	male
Talbot	male
Rahul	male
Barnabe	male
Hewie	male
Andri	male
Judi	female
Tyne	female
Peri	female
Genia	female
Jaquelyn	female
Isador	male
Merrile	female
Rina	female
Judson	male
Suzy	female
Shamus	male
Bonny	female
Gwendolyn	female
Shelbi	female
Zarla	female
Mohammed	male
Everett	male
Waly	female
Evvie	female
Siana	female
Bari	female
Yale	male
Karlee	female
Mira	female
Tommy	male
Renault	male
Alfred	male
Gill	female
Pietra	female
Gilligan	female
Stefano	male
Pippa	female
Chrysler	female
Goldarina	female
Olin	male
Velvet	female
Geraldine	female
Ruthanne	female
Edyth	female
Caleb	male
Siegfried	male
Ola	female
Erica	female
Birgit	female
Hannie	female
Adore	female
Trudey	female
Courtenay	female
Meggan	female
Torry	male
Nitin	female
Blaire	female
Hilde	female
Evelyn	female
Gretta	female
Bill	female
Magnum	male
Ryann	female
Alaine	female
Klara	female
Chryste	female
Adina	female
Hedda	female
Dodi	female
Ambur	female
Merle	male
Chester	male
Jobie	female
Samuele	male
Raleigh	male
Parwane	female
Weston	male
Van	female
Abbott	male
Evonne	female
Verine	female
Pincus	male
Gabriel	female
Shelia	female
Kelci	female
Tracie	male
Linnie	female
Ruby	male
Salvidor	male
Beowulf	male
Brandy	male
Gale 	female
Adrien	male
Rene	female
Rica	female
Danell	female
Geri	male
Fara	female
Megen	female
Maxfield	male
Janey	female
Janetta	female
Marybelle	female
Scarlett	female
Antoinette	female
Ronalda	female
Celeste	female
Owen	male
Cloris	female
Jean-Pierre	male
Alejandrina	female
Estrella	female
Eva	female
Christen	female
Brunella	female
Barclay	male
Lanna	female
Cherye	female
Dorrie	female
Witty	male
Essie	female
Nikita	male
Clemmy	female
Adelaide	female
Sawyere	male
Missie	female
Meghann	female
Lenny	male
Kraig	male
Sheila	female
Audie	female
Zia	female
Galen	male
Kaitlynn	female
Melita	female
Pier	female
Wilmar	male
Marney	female
Shadow	male
Norman	male
Jefry	male
Rici	female
Kathlene	female
Hussein	male
Bobbie	male
Shirlene	female
Marlena	female
Angelo	male
Hans-Peter	male
Anais	female
Kristina	female
Dorisa	female
Issi	female
Barri	male
Geo	male
Gladi	female
Keriann	female
Percy	male
Sayre	male
Goddart	male
Vern	male
Adam	male
Raina	female
Connor	male
Willey	male
Ferdinande	female
Kriste	female
Wain	male
Rube	male
Case	male
Jean-Francois	male
Sile	female
Briny	female
Mordecai	male
Georgia	male
Marve	male
Henryetta	female
Arnoldo	male
Tull	male
Aliza	female
Jimmie	male
Zane	male
Cresa	female
Tabbatha	female
Phil	male
Benny	female
Juanita	female
Ede	female
Chelsey	female
Sabrina	female
Aubrey	female
Bela	male
Vanda	female
Arvind	male
Tiena	female
Oprah	female
Sibbie	female
Bobby	male
Shana	female
Colette	female
Laird	male
Emalia	female
Nena	female
Lorrayne	female
Odella	female
Elyssa	female
Riley	male
Palmer	male
Zonnya	female
Bryn	female
Rayna	female
Conni	female
Rockwell	male
Penelope	female
Delinda	female
Sada	female
Waverly	male
Rafaelita	female
Queenie	female
Timmi	female
Jenette	female
Bernete	female
Bartlett	male
Graham	male
Ignace	male
Andrus	male
Valenka	female
Dewitt	male
Marybeth	female
Concettina	female
Edgardo	male
Garvey	male
Ardella	female
Ofilia	female
Janina	female
Audi	female
Clarette	female
Aila	female
Herculie	male
Jerrilyn	female
Leeanne	female
Tova	female
Nealon	male
Hulda	female
Deb	female
Felisha	female
Tristan	male
Cherish	female
Teador	male
Karol	female
Marianna	female
Roselia	female
Michail	male
Felipa	female
Zackariah	male
Samantha	female
Tabor	male
Robinetta	female
Zacharia	male
Wini	female
Sharl	female
Grata	female
Alix	male
Saraann	female
Milt	male
Lysandra	female
Sibby	female
Rheba	female
Elwina	female
Winny	female
Carter	male
Walton	male
Fawna	female
Maurine	female
Nester	male
Ofella	female
April	female
Gennie	female
Dieter	male
Pembroke	male
Bria	female
Joycelin	female
Alyse	female
Luigi	male
Jacquetta	female
Ladonna	female
Cybill	female
Irena	female
Heda	female
Phelia	female
Marin	female
Martie	female
Luelle	female
Marsh	male
Craig	male
Stacia	female
Dollie	female
Darian	male
Yehudit	female
Ryan	male
Selestina	female
Nestor	male
Maure	female
Arlena	female
Westley	male
Taber	male
Adelle	female
Trey	male
Robyn	female
Antonetta	female
Cal	male
Anatol	male
Fyodor	male
Arlene	female
Durward	male
Scarlet	female
Lust	female
Maison	male
Slim	male
Brody	male
Mag	female
Otha	female
Jaimie	female
Jeraldine	female
Germaine	male
Jeniece	female
Maddie	female
Renell	female
Carma	female
Franny	female
Ariel	female
Edy	female
Sparky	male
Tomasine	female
Rosabel	female
Evette	female
Claude	male
Dolorita	female
Peg	female
Orelie	female
Chip	male
Desiree	female
Othilie	female
Wit	male
Cyrillus	male
Christorpher	male
Herbert	male
Kristien	female
Yolane	female
Marshal	male
Loni	female
Tana	female
Minnie	female
Tara	female
Sisile	female
Sholom	male
Claribel	female
Frans	male
Marv	male
Elenore	female
Bess	female
Heidi	female
Sigmund	male
Eustace	male
Constantina	female
Patricio	male
Cinderella	female
Verla	female
Louisa	female
Amandy	female
Antonin	male
Noelle	female
Lynda	female
Eleanor	female
Clotilda	female
John	male
Britani	female
Linet	female
Whitby	male
Iris	female
Faina	female
Coleman	male
Gert	female
Quent	male
Marietta	female
William	male
Sheff	male
Bjorne	male
Dick	male
Errol	male
Etti	female
Lesli	female
Tymothy	male
Melodee	female
Pail	male
Sybilla	female
Dell	male
Sinclair	male
Bealle	male
Vijay	male
Jillayne	female
Myranda	female
Trudy	female
Harley	female
Gina	female
Imogene	female
Mollee	female
Zebulon	male
Erick	male
Andrzej	male
Terri	female
Othelia	female
Newton	male
Emlynne	female
Pennie	female
Tawsha	female
Theada	female
Sebastiano	male
Adaline	female
Merrel	male
Normie	male
Marchelle	female
Lionel	male
Carey	female
Quinn	female
Anja	female
Tuck	male
Barth	male
Sloan	male
Elena	female
Thaddeus	male
Chantalle	female
Olwen	female
Holli	female
Hercules	male
Moria	female
Penn	male
Kathie	female
Junie	female
Moreen	female
Wilson	male
Kurt	male
Bianka	female
Ann-Marie	female
Rhianon	female
Barry	male
Elli	female
Konstance	female
Annabal	female
Odele	female
Cristopher	male
Laurie	female
Ulysses	male
Pryce	male
Heinz	male
Welby	male
Lewis	male
Nesta	female
Cristi	female
Willy	male
Charlton	male
Lin	female
Englebert	male
Consolata	female
Mel	female
Darcie	female
Ronald	male
Cody	male
Cyrus	male
Meredeth	male
Dennis	male
Raye	female
Kimberlee	female
Barnebas	male
Faydra	female
Alfreda	female
Elfie	female
Sella	female
Ardra	female
Elsey	female
Lizbeth	female
Herta	female
Amelina	female
Marlee	female
Merci	female
Harvie	male
Dwain	male
Dyane	female
Toma	female
Tabbie	male
Haley	female
Remy	female
Gerold	male
Brea	female
Klarika	female
Elwyn	male
Margarita	female
Nathanial	male
Ulick	male
Thedrick	male
Jade	female
Jody	male
Tarrant	male
Dory	male
Cristine	female
Karine	female
Zandra	female
Clemente	male
Omar	male
Gerhard	male
Stella	female
Regina	female
Blakeley	female
Laila	female
Ursala	female
Helen-Elizabeth	female
Wendi	female
Verina	female
Shell	female
Josef	male
Michell	female
Franklin	male
Barn	male
Vite	male
Mack	male
Emily	female
Jemie	female
Charleton	male
Karlyn	female
Madalyn	female
Arne	male
Celinka	female
Sharona	female
Mair	female
Salli	female
Rubetta	female
Davin	male
Cassandra	female
Therine	female
Stewart	male
Titos	male
Harriott	female
Tomiko	female
Gerri	male
Janus	male
Jae	male
Emmalyn	female
Jammie	female
Zorah	female
Melisse	female
Trever	male
Tremayne	male
Laney	female
Corrie	male
Dari	female
Lynnell	female
Edsel	male
Clemmie	female
Lanny	female
Karrie	female
Bev	female
Karoline	female
Vere	female
Gill	male
Rafaela	female
Fina	female
Hettie	female
Elijah	male
Phylis	female
Jennilee	female
Reid	male
Evangeline	female
Zeb	male
Scotty	male
Charo	female
Rachelle	female
Armond	male
Gonzalo	male
Correna	female
Charita	female
Hubert	male
Cheston	male
Shaine	male
Lavina	female
Hebert	male
Elysia	female
Augie	male
Babs	female
Ondrea	female
Gerty	female
Trace	male
Joice	female
Benton	male
Adams	male
Norm	male
Sallyann	female
Leta	female
Paige	female
Mort	male
Hinda	female
Schroeder	male
Yancy	male
Brandice	female
Florry	female
Constancy	female
Jeremias	male
Salim	male
Tomasina	female
Raphaela	female
Arther	male
Lenee	female
Conney	female
Irving	male
Osborn	male
Amalie	female
Sybila	female
Rodolphe	male
Audry	female
Rosalie	female
Cherri	female
Jerrome	male
Dea	female
Skyler	male
Kiah	female
Anne-Marie	female
Tiff	female
Jean	female
Malina	female
Sinclare	male
Nada	female
Christin	female
Roxi	female
Joby	female
Vachel	male
Tate	male
Antonio	male
Petra	female
Nadean	female
Kristin	female
Almire	female
Arnie	male
Malcolm	male
Godfrey	male
Allyce	female
Lorenzo	male
Theadora	female
Anastasie	female
Lynnet	female
Henka	female
Tailor	male
Alvinia	female
Waiter	male
Clemens	male
Deina	female
Matias	male
Lothar	male
Marcos	male
Keil	male
Jewel	female
Ramsay	male
Mildred	female
Calla	female
Hatty	female
Bartolomeo	male
Alyss	female
Nalani	female
Loria	female
Kendall	male
Ruperta	female
Roxie	female
Angy	female
John-David	male
Butler	male
Karil	female
Dalia	female
Victoria	female
Jamie	male
Elsa	female
Ginny	female
Piotr	male
Lilias	female
Barbe	female
Katheryn	female
Thatcher	male
Chere	female
Amalle	female
Kaja	female
Glynda	female
Kimball	male
Kore	female
Jacob	male
Doti	female
Fidelia	female
Else	female
Luce	female
Merril	male
Willem	male
Tomlin	male
Cori	female
Sherwood	male
Jack	male
Jude	female
Ursa	female
Aubry	female
Perrine	female
Ruperto	male
Berkeley	male
Jemima	female
Ewart	male
Karyl	female
Randee	female
Jaleh	female
Tricia	female
Josefina	female
Krystyna	female
Steward	male
Carroll	female
Abraham	male
Antoni	male
Micky	male
Forrest	male
Kate	female
Pen	female
Sanson	male
Lynsey	female
Poul	male
Yank	male
Tracie	female
Corby	male
Kikelia	female
Gen	female
Olympie	female
Joli	female
Sammy	female
Flin	male
Chaim	male
Lindy	female
Marion	male
Lezlie	female
Arianne	female
Salvador	male
Mace	male
Danielle	female
Jermaine	female
Roderick	male
Reyna	female
Myke	male
Jackelyn	female
Sibyl	female
Emanuela	female
Malynda	female
Bradly	male
Guinna	female
Doralia	female
Fleming	male
Gregorio	male
Jennette	female
Darrel	male
Dela	female
Dody	female
Herbie	male
Mylo	male
Morgan	female
Dana	male
Garwood	male
Hetty	female
Loella	female
Katee	female
Olivette	female
Gordon	male
Olympe	female
Agnella	female
Gustaf	male
Ritchie	male
Tybi	female
Cammie	female
Darth	male
Felice	female
Elmore	male
Alaa	male
Albatros	male
Esme	male
Faith	female
Benjamin	male
Ivory	female
Shawn	female
Wilhelmina	female
Hedi	female
Kissie	female
Mallissa	female
Tamar	female
Saxe	male
Caroleen	female
Kerstin	female
Angie	female
Wileen	female
Angelina	female
Rosemaria	female
Monte	male
Leshia	female
Nari	female
Nolan	male
Mabel	female
Mallorie	female
Danila	female
Skipton	male
Deborah	female
Daisie	female
Gardner	male
Lotta	female
JoAnne	female
Yonina	female
Giorgi	male
Berny	female
Clarita	female
Ivonne	female
Tommy	female
August	male
Marven	male
Fiona	female
Tracey	female
Cammy	male
Emmy	male
Marni	female
Martelle	female
Madelyn	female
Sophey	female
Nerita	female
Paula-Grace	female
Shalne	female
Thedric	male
Nichole	male
Jervis	male
Igor	male
Celisse	female
Pat	male
Izabel	female
Bennie	female
Amelie	female
Aleda	female
Liana	female
Aristotle	male
Cheri	female
Carmita	female
Arron	male
Bobbi	female
Zoe	female
Rodd	male
Lulu	female
Teri	female
Hoyt	male
Vivianne	female
Margret	female
Mareah	female
Christiane	female
Retha	female
Kirsten	female
Annelise	female
Starla	female
Jilleen	female
Dallas	male
Ajai	male
Oren	male
Francis	female
Joanne	female
Harri	female
Bethany	female
Barton	male
Delora	female
Bernadine	female
Karissa	female
Philipa	female
Dominic	male
Marge	female
Phillie	female
Shel	female
Leda	female
Patrice	male
Constance	female
Tony	male
Fletch	male
Barnie	male
Coreen	female
Natalina	female
Ulric	male
Ninnette	female
Lia	female
Joelynn	female
Marthena	female
Georgia	female
Parke	male
Rania	female
Roseann	female
Zilvia	female
Melesa	female
Shaylah	female
Skipper	male
Trev	male
Rosalinda	female
Marvin	male
Carlee	female
Jacquenetta	female
Roobbie	female
Rebekah	female
Vilhelm	male
Ernst	male
Jory	male
Lindy	male
Patin	male
Weslie	male
Vivianna	female
Heidie	female
Randie	male
Donnie	female
Hillery	male
Carol	female
Natalie	female
Marleen	female
Nev	male
Kimmy	female
Flossy	female
Elnar	male
Tabby	female
Romy	female
Glory	female
Maurise	female
Berry	female
Major	male
Grover	male
Stillmann	male
Gerrard	male
Janna	female
Chloe	female
Stacie	female
Harlan	male
Benji	male
Carlye	female
Jeniffer	female
Baldwin	male
Dannie	female
Malva	female
Duffy	male
Kanya	female
Skipp	male
Fernanda	female
Mady	female
Frederich	male
Madelene	female
Bert	male
Lorrin	female
Lowell	male
Elroy	male
Elfrida	female
Amberly	female
Joyann	female
Mercie	female
Antone	male
Opalina	female
Trula	female
Ertha	female
Waverley	male
Clem	female
Ninnetta	female
Annamaria	female
Crystie	female
Leonie	female
Reuben	male
Russell	male
Jordan	male
Gavriel	male
Caren	female
Augustin	male
Sandro	male
Gaynor	female
Betti	female
Vonni	female
Sashenka	female
Kiley	female
Alessandro	male
Trudie	female
Haleigh	male
Doralyn	female
Leeann	female
Beale	male
Tam	male
Simon	male
Bartolemo	male
Gregor	male
Marris	female
Francene	female
Sunny	female
Carolina	female
Kareem	male
Happy	female
Chalmers	male
Doris	female
Vladamir	male
Anica	female
Charyl	female
Paolina	female
Phillis	female
Stephannie	female
Lainey	female
Letta	female
Corliss	female
Yoko	female
Mamie	female
Benita	female
Agnes	female
Janka	female
Elmira	female
Bonita	female
Renee	female
Davis	male
Harley	male
Finley	male
Paloma	female
Jerzy	male
Helene	female
Salmon	male
Tersina	female
Carlena	female
Schuyler	male
Merrie	female
Jolene	female
Trenton	male
Delphinia	female
Jeanna	female
Benny	male
Shari	female
Berrie	female
Brook	male
Laurella	female
Adrianna	female
Dell	female
Raul	male
Doreen	female
Ciara	female
Wakefield	male
Meryl	male
Dolly	female
Lotti	female
Alfie	male
Gusta	female
Brenna	female
Gifford	male
Torr	male
Derrol	male
Ken	male
Elene	female
Al	male
Barbette	female
Fatima	female
Clarisa	female
Violetta	female
Mame	female
Gladis	female
Nicki	female
Richardo	male
Evvy	female
Carlynn	female
Sauncho	male
Guendolen	female
Inesita	female
Clair	female
Zared	male
Misty	female
Marget	female
Graig	male
Evangelina	female
Ardine	female
Annemarie	female
Allie	female
Amandi	female
Georg	male
Cris	female
Gomer	male
Allin	male
Wrennie	female
Sybyl	female
Sean	female
Robinette	female
Marjy	female
Dora	female
Luther	male
Ronny	male
Ollie	female
Emil	male
Arabele	female
Susanna	female
Mendie	male
Yuri	male
Jonathon	male
Ilse	female
Prue	female
Thorpe	male
Peggie	female
Guglielma	female
Diann	female
Stormie	female
Codie	female
Dino	male
Zonda	female
Farand	female
Garp	male
Helsa	female
Marigold	female
Karie	female
Stoddard	female
Puff	male
Debbra	female
Waylon	male
Jeremie	male
Brunhilda	female
Daniella	female
Meagan	female
Briney	female
Corbin	male
Lee	female
Mikael	male
Vanya	female
Dix	female
Casi	female
Bary	male
Northrup	male
Glenda	female
Rona	female
Andreas	male
Adriana	female
Donnie	male
Moises	male
Wilie	female
Izak	male
Kelvin	male
Glen	male
Ros	female
Brinkley	male
Kelwin	male
Dodie	female
Ami	female
Korie	female
Nancy	female
Hali	female
Crissy	female
Hunt	male
Camella	female
Salman	male
Tally	male
Alice	female
Violette	female
Gertrudis	female
Saba	female
Charil	female
Mikey	male
Liora	female
Archon	male
Crystal	female
Marlin	male
Maryjo	female
Bryant	male
Lawrence	male
Phillida	female
Nariko	female
Ximenez	male
Bryan	male
Pattie	male
Esma	female
Jenilee	female
Judy	male
Beatriz	female
Jena	female
Allie	male
Wolfie	male
Min	female
Elonore	female
Delphina	female
Thomasina	female
Fionnula	female
Bud	male
Eben	male
Marcile	female
Blancha	female
Alphonso	male
Jennine	female
Roselle	female
Linell	female
Margaretta	female
Christofer	male
Heide	female
Domenico	male
Alecia	female
Benedetta	female
Tarra	female
Katrina	female
Maxwell	male
Serge	male
Kasey	female
Shaughn	male
Sapphira	female
Meaghan	female
Wallis	male
Devonna	female
Bee	female
Keene	male
Bernardine	female
Enrica	female
Tania	female
Tamiko	female
Adrea	female
Griselda	female
Amalita	female
Ruddy	male
Martynne	female
Michale	male
Turner	male
Lazar	male
Freeman	male
Devonne	female
Andy	female
Judd	male
Matthias	male
Salem	male
Giffer	male
Garry	male
Urbano	male
Jef	male
Zebulen	male
Elwin	male
Blondell	female
Lyssa	female
Hendrick	male
Waring	male
Willyt	female
Tedi	female
Christian	female
Mickey	male
Tedra	female
Markos	male
Bernardina	female
Olly	female
Ludwig	male
Zena	female
Dulci	female
Stephenie	female
Linnell	female
Walt	male
Vitoria	female
Gretal	female
Shell	male
Noelyn	female
Alexi	female
Carly	female
Shelby	female
Allen	male
Marry	female
Quintilla	female
Aggi	female
Ericha	female
Clayton	male
Rawley	male
Eimile	female
Ashton	male
Osmund	male
Brande	female
Lay	male
Margi	female
Germana	female
Helmuth	male
Michaelina	female
Amalea	female
Miran	female
Raphael	male
Prunella	female
Mario	male
Otis	male
Ike	male
Odilia	female
Bruno	male
Joya	female
Zuzana	female
Willetta	female
Glenn	male
Bancroft	male
Chickie	female
Melissa	female
Ardenia	female
Moll	female
Alfredo	male
Bessie	female
Kelly	male
Raj	male
Rosy	female
Clarinda	female
Kayla	female
Hashim	male
Mikel	male
Basia	female
Brock	male
Sissy	female
Husain	male
Aylmer	male
Tiler	male
Winona	female
Stew	male
Wendel	male
Reggie	male
Brana	female
Gloriane	female
Hendrik	male
Dudley	male
Virgina	female
Philis	female
Lyn	female
Masha	female
Arabela	female
Broddie	male
Harmonia	female
Melisandra	female
Neall	male
Matilde	female
Aleck	male
Kelila	female
Sibylle	female
Peta	female
Shelli	female
Clayborne	male
Clifton	male
Astrix	female
Cornela	female
Deidre	female
Stephani	female
Estelle	female
Eadith	female
Lynnea	female
Randie	female
Leigha	female
Trixy	female
Pedro	male
Huey	male
Alexis	female
Meyer	male
Rhodia	female
Cassondra	female
Dione	female
Chelsie	female
Nicole	female
Andrea	male
Roseanne	female
Jamey	male
Thad	male
Micaela	female
Isidora	female
Kaari	female
Natale	male
Junina	female
Travers	male
Hallam	male
Terry	male
Ruella	female
Brant	male
Wynny	female
Blare	male
Liuka	female
Brietta	female
Tammi	female
Ibby	female
Ilana	female
Maybelle	female
Vida	female
Didi	female
Aime	female
Kip	female
Robert	male
Jyoti	female
Tove	female
Kizzie	female
Ottilie	female
Ange	female
Lilas	female
Renelle	female
Melva	female
Elwood	male
Rowena	female
Tito	male
Dwane	male
Thayne	male
Zitella	female
Barney	male
Thaddius	male
Rickey	male
Shellie	female
Ebonee	female
Olimpia	female
Shepperd	male
Gabi	female
Chev	male
Jillane	female
Tiffi	female
Darla	female
Lavinia	female
Cathe	female
Bobinette	female
Lissy	female
Kendra	female
Berget	female
Pauly	female
Honey	female
Kyle	male
Tamara	female
Anders	male
Deerdre	female
Lissi	female
Lucien	male
Malinde	female
Willabella	female
Michaella	female
Stephan	male
Janot	female
Malia	female
Tresa	female
Malcah	female
Jackie	male
Luisa	female
Thane	male
Carlotta	female
Catlaina	female
Clementia	female
Fannie	female
Jacquie	female
Lilah	female
Sivert	male
Minna	female
Woochang	male
Josey	female
Joab	male
Sturgis	male
Rustin	male
Nanete	female
Marianne	female
Herman	male
Tobie	female
Murdock	male
Thorndike	male
Lyda	female
Aubrette	female
Chase	male
Daphne	female
Martainn	male
Jody	female
Huntington	male
Archibold	male
Shurwood	male
Melvyn	male
Suki	female
Hyatt	male
Lawson	male
Hendrika	female
Geraldo	male
Franz	male
Ranee	female
Noel	female
Annabel	female
Alix	female
Ephram	male
Ginnifer	female
Enya	female
Lion	male
Loree	female
Rafael	male
Maryanna	female
Sky	male
Bartholomeus	male
Edwin	male
Stacy	female
Piggy	male
Pip	male
Clarance	male
Uriel	male
Cristy	female
Delcine	female
Lizette	female
Jean-Christophe	male
Ariel	male
Cory	female
Annmaria	female
Dotty	female
Rolland	male
Megan	female
Benito	male
Chloette	female
Chet	male
Dannie	male
Liane	female
Roselyn	female
Bunny	female
Celestine	female
Alyda	female
Emmet	male
Rikki	male
Emeline	female
Mustafa	male
Kerianne	female
Kellia	female
Ingaborg	female
Ali	female
Ferinand	male
Hogan	male
Sheba	female
Harold	male
Bridgette	female
Ira	male
Sharia	female
Arlana	female
Heather	female
Lucie	female
Hesther	female
Tamarra	female
Spiros	male
Reggi	female
Karilynn	female
Stu	male
Emilee	female
Raf	female
Daisey	female
Sapphire	female
Dorry	female
Shanie	female
Tyrone	male
Allys	female
Kennedy	male
Laurence	male
Randolph	male
Nanny	female
Ofelia	female
Genna	female
Dani	female
Adi	female
Brett	female
Agna	female
Allan	male
Lynelle	female
Erna	female
Barnett	male
Shoshie	female
Clo	female
Joy	female
Wolfy	male
Cameron	male
Leandra	female
Claudelle	female
Marwin	male
Merle	female
Susy	female
Worthington	male
Harli	female
Dahlia	female
Corabella	female
Matty	male
Alston	male
Sosanna	female
Sly	male
Ezekiel	male
Nola	female
Stephen	male
Essa	female
Gleda	female
Rutherford	male
Westbrook	male
Libbey	female
Yigal	male
Hillard	male
Denyse	female
Lynnelle	female
Ardath	female
Mersey	female
Edita	female
Mikhail	male
Jillene	female
Whitney	male
Cathy	female
Cecilia	female
Cornelia	female
Gerald	male
Storm	female
Cecelia	female
Viole	female
Guenna	female
Elric	male
Julieta	female
Tanny	male
Rolf	male
Reube	male
Reynard	male
Alanah	female
Pooh	male
Keenan	male
Sigfrid	male
Keely	female
Layne	female
Helise	female
Biff	male
Clair	male
Bette-Ann	female
Belicia	female
Jere	female
Horace	male
Krissy	female
Vernice	female
Nedda	female
Huntlee	male
Celina	female
Lorne	male
Tarrah	female
Montgomery	male
Ez	male
Brandon	male
Winifred	female
Noell	female
Cynthie	female
Philippa	female
Zea	female
Tilda	female
Carrie	female
Garland	female
Trace	female
Kath	female
Blithe	female
Teryl	female
Charlean	female
Demetris	male
Merola	female
Hugh	male
Riva	female
Dulciana	female
Yehudi	male
Teodor	male
Ephraim	male
Townsend	male
Oneida	female
Gusti	female
Endora	female
Sileas	female
Rubia	female
Audre	female
Ismail	male
Fredrick	male
Orelee	female
Konstanze	female
Birgitta	female
Genny	female
Elfreda	female
Cyndy	female
Corissa	female
Evangelin	female
Langston	male
Prudy	female
Giff	male
Marlo	female
Candi	female
Petunia	female
Laurena	female
Ashby	male
Sharra	female
Nilson	male
Standford	male
Renate	female
Steffen	male
Cicely	female
Nan	female
Corrina	female
Jameson	male
Diego	male
Karlen	female
Emelyne	female
Juergen	male
Petronille	female
Renel	female
Becca	female
Claudine	female
Fredric	male
Jethro	male
Sammie	male
Celene	female
Thain	male
Roman	male
Sidnee	male
Gay	male
Lisabeth	female
Stephanus	male
Tandie	female
Ray	male
# Thanks to Bill Ross for about 1000 additional names.	male
Bartholomeo	male
Alene	female
Lura	female
Dugan	male
Garrett	male
Cynthy	female
Ellie	female
Garnet	female
Ingaberg	female
Mariquilla	female
Marji	female
Cecily	female
Ginelle	female
Yolanthe	female
Ramona	female
Joyce	female
Shannan	male
Neale	male
Cacilia	female
Rickie	female
Tonnie	male
Windy	female
Mayda	female
Bernadette	female
Janaya	female
Logan	male
Jaime	male
Julina	female
Ravil	male
Janith	female
Kass	female
Faunie	female
Penny	male
Saudra	female
Ailyn	female
Ignaz	male
Vincents	male
Geeta	female
Evita	female
Barbabas	male
Ajay	female
Kassia	female
Bartholemy	male
Rosaleen	female
Bart	male
Felicdad	female
Wait	male
Zak	male
Sharline	female
Worthy	male
Quintus	male
Ester	female
Abelard	male
Alta	female
Tomi	female
Roderigo	male
Gianina	female
Rhett	male
Richy	male
Maryellen	female
Rozele	female
Holley	female
Hermina	female
Aditya	male
Pegeen	female
Jenni	female
Alexis	male
Hazel	male
Eolande	female
Annamari	female
Keri	female
Astra	female
Tray	male
Abbe	female
Nadya	female
Marnie	female
Tarzan	male
Julissa	female
Tomkin	male
Hilary	female
Bathsheba	female
Humphrey	male
Augusta	female
Suzzy	female
Shayla	female
Roanne	female
Gerhardt	male
Michaela	female
Bettie	female
Jobye	female
Eliza	female
Chris	female
Nance	female
Opal	female
Lari	female
Mellicent	female
Codi	female
Bear	male
Leroy	male
Clareta	female
Redford	male
Augustine	male
Fitz	male
Eula	female
Emmott	male
Mercedes	female
Stepha	female
Ebenezer	male
Ransell	male
Verne	male
Karin	female
Elita	female
Margy	female
Corine	female
Persis	female
Aleks	male
Buffy	female
Greg	male
Burta	female
Kenton	male
Johann	male
Manda	female
Analise	female
Barnabas	male
Ethelin	female
Temple	male
Ivor	male
Michal	female
Calida	female
Christopher	male
Gilbertina	female
Christabelle	female
Wilburt	male
Pierce	male
Jenine	female
Alic	male
Joye	female
Josie	female
Dunstan	male
Maggee	female
Gita	female
Lea	female
Andrey	male
Clement	male
French	male
Devi	female
Joelie	female
Kira	female
Sabina	female
Taffy	female
Stefanie	female
Cathi	female
Ramesh	male
Bryn	male
Walsh	male
Yetty	female
Kyla	female
Alley	male
Cherianne	female
Starlin	female
Kerrin	female
Mignon	female
Thibaut	male
Gasper	male
Ashely	female
Derby	male
Giffie	male
Gail	female
Kessiah	female
Merridie	female
Abby	male
Armstrong	male
Bogart	male
Anna-Diana	female
Hamilton	male
Helli	female
Maximilien	male
Zebadiah	male
Chrisy	male
Syd	male
Morgana	female
Axel	male
Iggy	male
Sylvester	male
Ivette	female
Malissia	female
Clive	male
Karita	female
Bucky	male
Dyson	male
Yves	male
Carol-Jean	female
Lambert	male
Philippe	female
Linn	female
Lottie	female
Melany	female
Brynne	female
Jennie	female
Janel	female
Emlyn	female
Jacquelynn	female
Kaylyn	female
Brenn	female
Hilda	female
Carlyle	male
Barb	female
Roby	female
Manny	male
Karlotta	female
Amory	male
Dotti	female
Pace	male
Mimi	female
Giavani	male
Theophyllus	male
Winston	male
Tessie	female
Candie	female
Eugenie	female
Harris	male
Renaud	male
Andre	male
Rozelle	female
Chevalier	male
Ossie	male
Dougie	male
Simmonds	male
Winnie	male
Christoph	male
TeresaAnne	female
Madelina	female
Gere	male
Austine	female
Berenice	female
Kyle	female
Matthaeus	male
Theodora	female
June	female
Jonah	male
Hastings	male
Lennie	male
Lorene	female
Sonni	female
Alton	male
Florice	female
Anson	male
Charmine	female
Andrej	male
Karisa	female
Duke	male
Pablo	male
Meriel	female
Christel	female
Giacomo	male
Pascale	male
Lucy	female
Mugsy	male
Andros	male
Butch	male
Mora	female
Devinne	female
Jasmin	female
Munroe	male
Harriette	female
Arielle	female
Lil	female
Jodi	female
Oralie	female
Erich	male
Suzanne	female
Annalise	female
Jefferson	male
Lindsey	female
Isabelle	female
Nisse	female
Virginie	female
Daria	female
Augusto	male
Tyler	male
Georgena	female
Candace	female
Dorit	female
Zed	male
Nadeen	female
Gerard	male
Jacinda	female
Tasia	female
Elnore	female
Lionello	male
Aurore	female
Sayers	male
Elysee	female
Abigale	female
Averell	male
Alex	male
Wiatt	male
Elie	female
Sianna	female
Brigid	female
Randolf	male
Lib	female
Neille	female
Julius	male
Fionna	female
Selma	female
Dmitri	male
Abner	male
Amie	female
Inci	female
Ervin	male
Tobe	male
Cleopatra	female
Dani	male
Sidney	male
Fanechka	female
Kirk	male
Electra	female
Blythe	female
Lonee	female
Hildagarde	female
Caitlin	female
Scott	male
Thatch	male
Delaney	female
Hyacintha	female
Benetta	female
Kiri	female
Engelbert	male
Sayres	male
Anstice	female
Kandy	female
Marika	female
Tallia	female
Bailey	male
Casandra	female
Aleece	female
Iago	male
Casia	female
Sula	female
Patty	female
Jacky	female
Cathlene	female
Wheeler	male
Dabney	male
Sherilyn	female
Cecil	male
Yankee	male
Carlo	male
Barty	male
Zacherie	male
Saundra	male
Angil	female
Fredi	female
Bernardo	male
Clay	male
Conroy	male
Kinna	female
Rodge	male
Ricki	male
Timi	female
Cris	male
Beitris	female
Avis	female
Brooke	female
Lauree	female
Shaylynn	female
Denice	female
Ettie	female
Torrin	male
Way	male
Janice	female
Say	male
Ricki	female
Carmela	female
Derrin	male
Rolando	male
Veriee	female
Elinore	female
Saundra	female
Krystle	female
Zita	female
Nevin	male
Merv	male
Martina	female
Anett	female
Jana	female
Andres	male
Verene	female
Charmion	female
Guillema	female
Wolf	male
Neddie	male
Milena	female
Angus	male
Joslyn	female
Sussi	female
Pearline	female
Regen	male
Val	female
Zach	male
Rori	female
Dorree	female
Clara	female
Stanislaw	male
Neron	male
Cornelle	female
Addis	female
Lita	female
Gillan	female
Esmaria	female
Travis	male
Phillipe	male
Justina	female
Havivah	female
Galina	female
Eddie	female
Terrence	male
Phyllys	female
Nananne	female
Cari	female
Marcelline	female
Querida	female
Tom	male
Johnna	female
Skye	male
Sal	female
Rey	male
Scot	male
Ronni	female
Norina	female
Cyrill	male
Carolann	female
Roseanna	female
Adela	female
Gertrud	female
Doug	male
Reinhold	male
Merrielle	female
Iseabal	female
Aurora	female
Avraham	male
Tamra	female
Eolanda	female
Alf	male
Sean	male
Acacia	female
Ree	female
Teressa	female
Brandea	female
Annalena	female
Rad	male
Devondra	female
Katerine	female
Christie	male
Sylvan	male
Noemi	female
Neely	female
Esau	male
Sheffy	male
Maia	female
Bret	male
Terza	female
Gertrude	female
Marian	female
Octavius	male
Bo	female
Fabio	male
Jabez	male
Marjorie	female
Marten	male
Pierson	male
Tildie	female
Stevena	female
Lina	female
Leah	female
Blair	male
Kathy	female
Frazier	male
Ellen	female
Janaye	female
Gale	male
Fayette	female
Junette	female
Anjela	female
Hersh	male
Carson	male
Zelig	male
Kimmo	male
Juliet	female
Eberhard	male
Stanly	male
Isaiah	male
Lefty	male
Chadwick	male
Harlene	female
Luanna	female
Tore	male
Jannel	female
Anneliese	female
Joseph	male
Lew	male
Donetta	female
Bellamy	female
Leighton	male
Glyn	female
Emmalynne	female
Ginni	female
Katie	female
Dallas	female
Marcelo	male
Annabelle	female
Alessandra	female
Barret	male
Kai	female
Fitzgerald	male
Fortuna	female
Talbert	male
Jayme	female
Jerome	male
Avi	male
Flinn	male
Keefe	male
Floyd	male
Conchita	female
Darrell	male
Carena	female
Randal	male
Jaquenette	female
Warden	male
Giordano	male
Teddie	male
Corene	female
Marinna	female
Hildy	female
Ronda	female
Max	male
Hannis	female
Lisha	female
Mayer	male
Valma	female
Stesha	female
Wenona	female
Lisetta	female
Eddy	male
Dew	female
Fernando	male
Olenka	female
Kaye	female
Jesse	female
Penrod	male
Seana	female
Phillipp	male
Kylila	female
Charity	female
Suzann	female
# Version 1.3 (29-MAR-94)	female
Ned	male
Davine	female
Merrilee	female
Veradis	female
Meryl	female
Jared	male
Ashlie	female
Fan	female
Everard	male
Vassili	male
Ferdinand	male
Enoch	male
Florinda	female
Melania	female
Alford	male
Nadia	female
Vivien	female
Annissa	female
Irvin	male
Otes	male
Theresa	female
Dede	female
Quinn	male
Clarke	male
Karlie	female
Vanna	female
Vince	male
Claudius	male
Matty	female
Royce	male
Lola	female
Claire	male
Tine	female
Tanner	male
Niall	male
Marta	female
Gwenora	female
Lorettalorna	female
Lanny	male
Mariam	female
Agace	female
Mommy	female
Maribelle	female
Izzi	female
Juditha	female
Gabriell	female
Viviene	female
Lorne	female
Ella	female
Bing	male
Jens	male
Raoul	male
Mike	male
Evanne	female
Florenza	female
Louisette	female
Dulcine	female
Elle	female
Anthe	female
Cobbie	male
Sibylla	female
Linda	female
Daryl	male
Blake	male
Carin	female
Cherry	female
Stephanie	female
Janelle	female
Devon	female
Josephina	female
Shayne	male
Abigael	female
Cabrina	female
Dewey	male
Noach	male
Vinny	male
Gene	female
Germaine	female
Almeria	female
Heywood	male
Corinne	female
Ragnar	male
Virginia	female
Shannon	female
Paul	male
Hakim	male
Georgie	male
Pasquale	male
Lori	female
Kizzee	female
Curtis	male
Ignazio	male
Petronia	female
Joselyn	female
Aleen	female
Laurel	female
Geneva	female
Gypsy	female
Sheelagh	female
Catarina	female
Purcell	male
Norrie	female
Mara	female
Simonette	female
Cristionna	female
Patty	male
Kathe	female
Leontine	female
Jelene	female
Maggi	female
Katharina	female
Babette	female
Lesya	female
Gil	male
Emmaline	female
Ricky	male
Courtney	female
Henry	male
Tammy	female
Averyl	female
Hurley	male
Kirsteni	female
Lincoln	male
Dorian	male
Jud	male
Mandie	female
Jeri	female
Alla	female
Nannette	female
Kathryn	female
Lydia	female
Cally	female
Gwenn	female
Olivier	male
Noami	female
Catlin	female
Prudi	female
Parnell	male
Tracy	male
Shawna	female
Barbaraanne	female
Elisha	male
Saxon	male
Garold	male
Waldon	male
Jesselyn	female
Merrill	male
Norri	female
Idalina	female
Darryl	male
Zara	female
Bertina	female
Ingelbert	male
Joshua	male
Verena	female
Maryrose	female
Dalton	male
Arleen	female
Gigi	female
Skippie	male
Arlina	female
Charmian	female
Dulcea	female
Elicia	female
Saunder	male
Ritch	male
Thia	female
Torrie	female
Leoine	female
Jeffie	male
Urban	male
Sig	male
Cat	male
Kelsey	male
Isa	female
Tobye	female
Rock	male
Judas	male
Hailey	male
Levin	male
Ingram	male
Madelon	female
Dinah	female
Paddie	male
Moses	male
Theobald	male
Ollie	male
Jonell	female
Lloyd	male
Otho	male
Hildagard	female
Giorgio	male
Berkie	male
Billy	female
Hari	male
Tildi	female
Vin	female
Shelley	male
Griffin	male
Birdie	female
Miguela	female
Nessy	female
Lesley	male
Barbabra	female
Bidget	female
Sammy	male
Urbanus	male
Edmund	male
Krishna	male
Brynna	female
Bernadina	female
Caesar	male
Niels	male
Haily	female
Avrit	female
Ilona	female
Delilah	female
Wilhelm	male
Rebeka	female
Mortimer	male
Grier	female
Maudie	female
Rhodie	female
Dael	female
Romola	female
Clarie	female
Jenelle	female
Allissa	female
Wenda	female
Marje	female
Alethea	female
Kenn	male
Fiorenze	female
Tammie	female
Philbert	male
Sid	male
Leon	male
Jason	male
Moe	male
Inigo	male
Aubine	female
Abdel	male
Xenia	female
Morna	female
Joao	male
Larisa	female
Leslie	female
Alisa	female
Ardene	female
Holly	male
Walter	male
Beryl	female
Rozina	female
Cathryn	female
Blinny	female
Wallache	male
Judy	female
Fran	female
Mischa	male
Gregg	male
Agneta	female
Boyce	male
Cherise	female
Adolphe	male
Brittany	female
Gera	female
Marcio	male
Austen	male
Donielle	female
Katinka	female
Aurlie	female
Cariotta	female
Dasie	female
Nicoli	female
Phil	female
Paulina	female
Mia	female
Fawn	female
Leslie	male
Jock	male
Joelly	female
Sheri	female
Jeanine	female
Noreen	female
Cyrille	male
Lazare	male
Arliene	female
Waleed	male
Tremaine	male
Slade	male
Ozzie	male
Kurtis	male
Reginauld	male
Marcille	female
Heddie	female
Pansie	female
Zacharias	male
Tilly	female
Aprilette	female
Leilah	female
Curtice	male
Jennifer	female
Aloysia	female
Ariela	female
Amanda	female
Glennie	female
Amy	female
Vally	female
Shannah	female
Nerte	female
Heath	male
Emilio	male
Steve	male
Moyna	female
Liliane	female
Gerhardine	female
Murphy	male
Donald	male
Katlin	female
Romona	female
Adella	female
Gracie	female
Ellsworth	male
Allsun	female
Teriann	female
Rivi	female
Paton	male
Tymon	male
Dacia	female
Henriette	female
Mireielle	female
Constantia	female
Judye	female
Ethelind	female
Leonanie	female
Austina	female
Martha	female
Angel	male
Perry	male
Sharity	female
Aimil	female
Myriam	female
Starlene	female
Gwyneth	female
Pyotr	male
Tiffani	female
Dorthy	female
Vilma	female
Evie	female
Barris	male
Elise	female
Daryle	male
Odysseus	male
Coraline	female
Angelica	female
Merill	male
Karel	male
Colbert	male
Libbie	female
Friedrick	male
Andonis	male
Ramsey	male
Gisele	female
Chelsae	female
Javier	male
Morly	male
Siouxie	female
Tonya	female
Wilton	male
Reynolds	male
Ross	male
Vikky	female
Tasha	female
Roderic	male
Elsy	female
Emile	male
Bernard	male
Dimitrou	male
Osbourn	male
Derron	male
Udell	male
Maurits	male
Johnathan	male
Jasper	male
Claudia	female
Norbert	male
Brigida	female
Teddy	male
Vic	male
Lacee	female
Jude	male
Kelcey	female
Farica	female
Kirbie	female
Gwenette	female
Sanders	male
Debbi	female
Inez	female
Ulla	female
Edith	female
Timothy	male
Bernd	male
Joe	male
Salomon	male
Daryn	female
Elayne	female
Dasha	female
Izaak	male
Nanine	female
Rudolfo	male
Valentine	female
Shumeet	male
Adriane	female
Sandye	female
Jean	male
Raimund	male
Lurette	female
Durante	male
Menard	male
Dionysus	male
Winslow	male
Harmon	male
Marja	female
Bebe	female
Lela	female
Lesley	female
Ethan	male
Ivett	female
Desirae	female
Ingamar	male
Diane	female
Greggory	male
Carmel	female
Martita	female
Roanna	female
Dosi	female
Georgine	female
Amandie	female
Claudetta	female
Meggy	female
Odille	female
Rebe	female
Rosamond	female
Clemence	female
Gabriella	female
Nerti	female
Esther	female
Eliott	male
Karalee	female
Forster	male
Frannie	female
Valdemar	male
Dyna	female
Andree	female
Susann	female
Noah	male
Joellen	female
Katerina	female
Avery	male
Giselle	female
Cindi	female
Aeriell	female
Robin	female
Bride	female
Arabelle	female
Artur	male
Matelda	female
Bette	female
Si	male
Mitzi	female
Pru	female
Shannon	male
Carla	female
Lucinda	female
Amargo	female
Hellene	female
Hewe	male
Francesco	male
Flemming	male
Nelli	female
Oreste	female
Jeffry	male
Maridel	female
Michelle	female
Marietta	male
Anette	female
Orion	male
Cornellis	male
Jamie	female
Dietrich	male
Micheil	male
Vassily	male
Hewet	male
Normand	male
Martyn	male
Saw	male
Morlee	male
Darby	female
Gerry	female
Talia	female
Marrilee	female
Andrei	female
Ellette	female
Lily	female
Gertruda	female
Clari	female
Eda	female
Graeme	male
Shirleen	female
Mariana	female
Lou	female
Colene	female
Kylie	female
Lyndon	male
Dickey	male
Deloria	female
Betta	female
Milton	male
Clarissa	female
Christyna	female
Tybie	female
Madlen	female
Hope	female
Harriet	female
Hermine	female
Maritsa	female
Natala	female
Lisbeth	female
Scotty	female
Tressa	female
Ambrosio	male
Mohamad	male
Federico	male
Parker	male
Georges	male
Jeromy	male
Danella	female
Floria	female
Aldric	male
Rivalee	female
Amber	female
Danyelle	female
Laure	female
Derek	male
Fleurette	female
Sibelle	female
Lindsay	male
Clary	female
Silvie	female
Anallese	female
Rosaline	female
Son	male
Zachary	male
Philomena	female
Tybalt	male
Gaspar	male
Oral	male
Park	male
Remington	male
Lorette	female
Georgy	male
Margaux	female
Silvia	female
Gisela	female
Ashli	female
Adora	female
Eleanore	female
Lydie	female
Josephine	female
Ahmed	male
Anna	female
Morena	female
Karen	female
Marci	female
Ethyl	female
Aziz	male
Tonia	female
Garv	male
Virge	male
Wallie	male
Delphine	female
Hasheem	male
Alastair	male
Dionne	female
Ignacio	male
Nedi	female
Welsh	male
Maryanne	female
Ransom	male
Moore	male
Trenna	female
Burl	male
Judie	female
Ruby	female
Melitta	female
Ulrike	female
Jacqui	female
Janos	male
Wainwright	male
Loretta	female
Cassaundra	female
Horacio	male
Ina	female
Maurise	male
Horst	male
Jean-Paul	male
Marnia	female
Adolf	male
Chandal	female
Samuel	male
Gabriell	male
Kirstin	female
Michel	male
Emmalee	female
Shane	male
Tamera	female
Ursuline	female
Jessee	male
Taddeus	male
Maynord	male
Roger	male
Hobart	male
Maryjane	female
Colline	female
Alasdair	male
Hermann	male
Dickie	male
Aggy	female
Margarette	female
Risa	female
Foster	male
Delbert	male
Pennie	male
Claudie	female
Ricard	male
Thea	female
Ralina	female
Melamie	female
Salomone	male
Kermie	male
Zack	male
Ursulina	female
Maurita	female
Frieda	female
Demeter	female
Michel	female
Muffin	male
Vaughn	male
Eden	female
Rikki	female
Sarina	female
Ethelda	female
Rena	female
Rosemary	female
Lissie	female
Brandi	female
Israel	male
Aurie	female
Elyn	female
Carissa	female
Elsie	female
Lanni	female
Kip	male
Amery	male
Berke	male
Sophronia	female
Milly	female
Demetria	female
Dolores	female
Ed	male
Conway	male
Rhody	female
Emelina	female
Juan	male
Noelani	female
Isador	female
Hiram	male
Tess	female
Tucker	male
Erek	male
Riannon	female
Pansy	female
Kattie	female
Winford	male
Harland	male
Laverne	female
Josi	female
Mitchael	male
Berk	male
Demetris	female
Kaleena	female
Elisha	female
Ashish	male
Willa	female
Cyril	male
Elden	male
Dona	female
Fabian	male
Johnnie	male
Cristabel	female
Lorilyn	female
Marillin	female
Cissie	female
Weidar	male
Cyndi	female
Noe	male
Tobiah	male
Kalman	male
Quentin	female
Twila	female
Marcia	female
Randi	male
Binky	male
Miguel	male
Kalle	male
JoAnn	female
Sib	female
Hal	male
Aline	female
Reginald	male
Juliane	female
Zabrina	female
Orly	female
Dolora	female
Caterina	female
Mariele	female
Kermit	male
Rollin	male
Corilla	female
Spike	male
Val	male
Kimmi	female
Maible	female
Fedora	female
Kimberley	female
Melessa	female
Emmett	male
Pamela	female
Alex	female
Madison	male
Monroe	male
Jeth	male
Burton	male
Lebbie	female
Amalee	female
Esme	female
Laural	female
E'Lane	female
Oscar	male
Lidia	female
Gonzales	male
Bentley	male
Abe	male
Flynn	male
Hudson	male
Willamina	female
Cherice	female
Cindelyn	female
Englebart	male
Jesus	male
Augustine	female
Joelle	female
Yanaton	male
Bernadene	female
Wake	male
Shaun	male
Oralle	female
Nickey	male
Roth	male
Hollyanne	female
Wallis	female
Hillary	male
Anastasia	female
Amara	female
Marilu	male
Othella	female
Siffre	male
Wilek	male
Emogene	female
Patrica	female
Woody	male
Ibbie	female
Cristal	female
Midge	female
Lolly	female
Martica	female
Wyatt	male
Patel	male
Wolfram	male
Dorelle	female
Minni	female
Aleta	female
Kathrine	female
Juanita	male
Juana	female
Portia	female
Fianna	female
Felicia	female
Rupert	male
Cathrin	female
Raymund	male
Susanetta	female
Belva	female
Bonni	female
Natka	female
Wyndham	male
Reilly	male
Magna	female
Helyn	female
Arlinda	female
Reggy	male
Crista	female
Sharai	female
Quinton	male
Morty	male
Nikoletta	female
Georgetta	female
Maddie	male
Calypso	female
Wilmette	female
Monty	male
Stinky	male
Aeriela	female
Demetre	male
Collette	female
Hartley	male
Ame	female
Hallie	female
Myrlene	female
Pepillo	male
Avivah	female
George	female
Chris	male
Kin	male
Skip	male
Godfree	male
Web	male
Rex	male
Micheal	male
Katalin	female
Rayner	male
Margette	female
Webb	male
Caspar	male
Gideon	male
Annaliese	female
Osbourne	male
Emma	female
Batsheva	female
Forbes	male
Bendite	female
Mirilla	female
Sutton	male
Xever	male
Sheilah	female
Salome	female
Hezekiah	male
Chevy	male
Alberta	female
Preston	male
Maye	female
Ezra	male
Imojean	female
Troy	male
Xerxes	male
Cherrita	female
Meredith	male
Sheilakathryn	female
Wynnie	female
Joey	female
Vivian	female
Nelie	female
Phoebe	female
Bertha	female
Valeda	female
Gusty	female
Shlomo	male
Dorene	female
Simone	male
Michele	female
Perri	female
Keelia	female
Suzette	female
Enrique	male
Carri	female
Valentina	female
Shirlee	female
Vonnie	female
Robbie	female
Eunice	female
Ted	female
Torrey	male
Jessica	female
Gunilla	female
Kerrie	female
Buddy	male
Trisha	female
Cleo	female
Natalee	female
Leonora	female
Jermaine	male
Neel	male
Erinn	female
Bree	female
Hilliard	male
Fae	female
Lurlene	female
Dedie	female
Rochella	female
Henrietta	female
Meara	female
Layla	female
Marty	male
Del	female
Gerta	female
Carolynn	female
Selig	male
Sherri	female
Sheril	female
Babita	female
Florence	female
Juline	female
Noland	male
Gunter	male
Bettine	female
Pavel	male
Staford	male
Sherwynd	male
Barnard	male
Wayne	male
Christof	male
Millicent	female
Mavra	female
Louise	female
Mufi	female
Tally	female
Trevar	male
Chancey	male
Myra	female
Anna-Diane	female
Eliot	male
Agustin	male
Zechariah	male
Les	male
Mead	male
Gratia	female
Fabrice	female
Ron	male
Elvira	female
Nichols	male
Adrian	female
Norwood	male
Reagan	male
Goldi	female
Shep	male
Yelena	female
Voltaire	male
Ezechiel	male
Roselin	female
Dorena	female
Daune	female
Vittoria	female
Bertine	female
Tod	male
Toni	female
Korry	female
Frank	female
Ariana	female
Olag	male
Marylou	female
Daphna	female
Ilene	female
Jerrylee	female
Lynett	female
Teresita	female
Franni	female
Marissa	female
Karena	female
Richie	male
Jaclin	female
Godwin	male
Antin	male
Rusty	male
Kassandra	female
Seline	female
Sasha	female
Darius	male
Selinda	female
Sumner	male
Jenda	female
Sandie	female
Kaiser	male
Rorie	female
Robinet	female
Dianne	female
Franky	female
Verge	male
Trix	female
Vaclav	male
Dale	female
Kalil	male
Rodrigo	male
Aleksandrs	male
Giffard	male
Dov	male
Christal	female
Jo	male
Barr	male
Dianna	female
Roxanna	female
Joly	female
Michael	male
Thacher	male
Sarine	female
Herve	male
Geraldina	female
Rinaldo	male
Abdul	male
Valentia	female
Pavia	female
Gae	female
Vinnie	male
Murielle	female
Audrye	female
Blayne	male
Catherin	female
Gates	female
Benedikta	female
Norene	female
Harcourt	male
Walker	male
Francyne	female
Dorcas	female
Rachel	female
Denny	female
Diane-Marie	female
Dustin	male
Shayna	female
Tiffany	female
Pepita	female
Rubie	female
Obadias	male
Reinhard	male
Wojciech	male
Idalia	female
Aleecia	female
Kyrstin	female
Rosalia	female
Clare	female
Enrico	male
Nat	male
Melisenda	female
Maynard	male
Lynnett	female
Selene	female
Selby	male
Leena	female
Izzy	male
Dion	male
Orella	female
Yolanda	female
Erminie	female
Morse	male
Kial	female
Avram	male
Morgan	male
France	female
Kimberly	female
Chariot	male
Peyton	male
Fay	female
Matteo	male
Rosa	female
Devora	female
Roxane	female
Gilles	male
Sonny	male
Jacki	female
Noble	male
Arnold	male
Maren	female
Godard	male
Fanny	female
Kerrill	female
Casie	female
Vivyanne	female
Erika	female
Keith	male
Belinda	female
Rod	male
Catherina	female
Shannen	female
Katleen	female
Kathi	female
Katuscha	female
Adorne	female
Jerry	male
Elvis	male
Gratiana	female
Thurstan	male
Gizela	female
Roosevelt	male
Boniface	male
Timotheus	male
Haven	male
Ephrem	male
Koralle	female
Victor	male
Levon	male
Jerri	male
Robbert	male
Hilbert	male
Mmarianne	female
Ceil	female
Angelika	female
Felix	male
Berthe	female
Bernie	female
Kent	male
Loren	male
Mariya	female
Desmond	male
Donnajean	female
Chauncey	male
Lynne	female
Rochette	female
Korella	female
Gustavus	male
Malena	female
Lissa	female
Meridith	female
Suzi	female
Aileen	female
Vannie	female
Raquel	female
Louis	male
Elias	male
Douglass	male
Kathye	female
Orville	male
Rudiger	male
Evelina	female
Rosanna	female
Karolina	female
Joachim	male
Welbie	male
Ianthe	female
Nunzio	male
Torrence	male
Wittie	male
Ema	female
Jon	male
Libby	female
Johny	male
Rodie	female
Tillie	female
Jeff	male
Ernestine	female
Wade	male
Tully	male
Renata	female
Ana	female
Chaunce	male
Worden	male
Anestassia	female
Glynnis	female
Pammy	female
Alphonse	male
Anny	female
Annabella	female
Darelle	female
Elaine	female
Celesta	female
Hank	male
Gilbertine	female
Liorah	female
Ealasaid	female
Zulema	female
Forrester	male
Elsi	female
Mollie	female
Sharleen	female
Arvin	male
Chuck	male
Micki	female
Marla	female
Rand	male
Nara	female
Oralee	female
Deanne	female
Tanney	male
Shepard	male
Sally	female
Aloise	female
Damita	female
Caroljean	female
Delcina	female
Rennie	female
Lorie	female
Marty	female
Mendel	male
Cherida	female
Biddy	female
Ferdie	male
Tuckie	male
Myles	male
Kenna	female
Gilberte	female
Wally	male
Ewan	male
Rolph	male
Dunc	male
Gerianna	female
Silvana	female
Hammad	male
Cynthea	female
Mayor	male
Elspeth	female
Merrili	female
Haywood	male
Hanson	male
Lucienne	female
Wood	male
Cesya	female
Marga	female
Nerty	female
Jodie	male
Milzie	female
Perceval	male
Cherilyn	female
Fazeel	male
Earl	male
Austin	female
Samson	male
Berchtold	male
Emili	female
Hans	male
Clemmie	male
Vanny	female
Quigly	male
Mildrid	female
Rudolph	male
Richard	male
Clinten	male
Rocky	male
Sherwin	male
Cleveland	male
Monika	female
Mick	male
Veronika	female
Kendal	male
Melvin	male
Arel	male
Sheila-Kathryn	female
Leoline	female
Penni	female
Marthe	female
Oran	male
Jannelle	female
Shelby	male
Gunther	male
Alida	female
Pinchas	male
Rhiamon	female
Debbie	female
Marysa	female
Eve	female
Dorey	female
La	female
Lorelle	female
Brunhilde	female
Melinde	female
Malory	female
Frankie	male
Bellina	female
Nichol	female
Drew	female
Gayla	female
Matthus	male
Tracy	female
Jerold	male
Aldo	male
Shina	female
Josefa	female
Zelda	female
Gerome	male
Evania	female
Iormina	female
Ricca	female
Alis	female
Beverly	female
Ira	female
Marquita	female
Yule	male
Lark	female
Willie	female
Mead	female
Ermina	female
Wells	male
Howie	male
Carolyne	female
Farra	female
Urbain	male
Oralia	female
Herb	male
Cortese	male
Kaia	female
Sherry	female
Geri	female
Fernandina	female
Dorie	female
Kym	female
Carrissa	female
Vladimir	male
Mart	male
Alexina	female
Pamella	female
Eli	male
Justin	male
Moss	male
Karmen	female
Maximilian	male
Cecil	female
Adria	female
Genevra	female
Emory	male
Stacy	male
Bunni	female
Denna	female
Rafa	female
Lauren	male
Loreen	female
Kaylil	female
Bryce	male
Elka	female
Emanuel	male
Templeton	male
Leanna	female
Madelin	female
Hedwig	female
Chiarra	female
Lind	male
Ally	female
Rickie	male
Mellisent	female
Aube	male
Fraser	male
Redmond	male
Goddard	male
Wyn	male
Lilllie	female
Carleen	female
Norine	female
Mose	male
Donny	female
Elane	female
Jeffrey	male
Tabb	male
Sabine	female
Marcella	female
Chas	male
Demetrius	male
Beryle	female
Stafford	male
Thibaud	male
Wynn	female
Gordie	male
Fredra	female
Wendell	male
Terence	male
Freddy	female
Eyde	female
Hadria	female
Nadine	female
Kipp	female
Aura	female
Orren	male
Karna	female
Ardelle	female
Yalonda	female
Fox	male
Sarah	female
Esmeralda	female
Kathryne	female
Sadella	female
Susanne	female
Rosabella	female
Torie	female
Vinny	female
Abel	male
Hilliary	female
Patsy	male
Mattie	male
Angelia	female
Praneetf	male
Terina	female
Mohamed	male
Adrienne	female
Ty	male
Carmelina	female
Guinevere	female
Antonino	male
Nana	female
Creighton	male
Yoshiko	female
Caritta	female
Roberto	male
Aloisia	female
Kaylee	female
Amabel	female
Sela	female
Dawna	female
Waylen	male
Caralie	female
Wilburn	male
Amos	male
Benoite	female
Monica	female
Ventura	female
Rustie	male
Rabbi	male
Benjy	male
Indira	female
Cornie	female
Antonia	female
Aida	female
Nico	male
Brena	female
Udale	male
Sigfried	male
Bethena	female
Gershon	male
Hyman	male
Allina	female
Gredel	female
Charmaine	female
Atlanta	female
Jorge	male
Trip	male
Ahmad	male
Dillon	male
Aldrich	male
Althea	female
Corella	female
Tootsie	female
Morten	male
Clarence	male
Casey	male
Sting	male
Bernice	female
Savina	female
Katharyn	female
Corabelle	female
Brewer	male
Maud	female
Marlowe	male
Nannie	female
Stig	male
Gustavo	male
Chanda	female
Angelita	female
Roderich	male
Meggi	female
Maury	male
Charles	male
Gabriela	female
Theodor	male
Tracee	female
Kirsti	female
Rutter	male
John-Patrick	male
Margaret	female
Vasily	male
Flossi	female
Lauralee	female
Davita	female
Jaynell	female
Silvio	male
Calhoun	male
Jonny	male
Wallie	female
Arabella	female
Padraig	male
Calli	female
Erma	female
Tabitha	female
Edin	female
Lorry	female
Huntley	male
Dane	male
Philippine	female
Weider	male
Patience	female
Florrie	female
Antonella	female
Todd	male
Whittaker	male
Sissie	female
Jessamyn	female
Ferguson	male
Lenna	female
Heddi	female
Paige	male
Xaviera	female
Deanna	female
Corey	male
Erhard	male
Bellanca	female
Josselyn	female
Wilden	male
Nels	male
Lindsey	male
Tish	female
Fanchon	female
Tommie	male
Theda	female
Cacilie	female
Dulsea	female
Coral	female
Josiah	male
Nancie	female
Cele	female
Lucius	male
Yancey	male
Johanna	female
Larissa	female
Rory	female
Margo	female
Pauletta	female
Harlin	male
Renato	male
Carlynne	female
Christy	male
Darin	male
Kimbra	female
Adriena	female
Wynn	male
Hertha	female
Emmie	female
Krista	female
Teodoor	male
Garret	male
Alexa	female
Pris	female
Parsifal	male
Ammamaria	female
Mateo	male
Sallyanne	female
Peter	male
Jenna	female
Margie	female
Friedric	male
Waldo	male
Nick	male
# Version 1.3 (29-MAR-94)	male
Valry	female
Ag	female
Genovera	female
Rodrick	male
Andria	female
Norry	female
Corina	female
Raynard	male
Darline	female
Merry	male
Robena	female
Vlad	male
Terrill	male
Theodosia	female
Linette	female
Francisca	female
Ari	male
Annalyse	female
Konrad	male
Zaneta	female
Elissa	female
Minta	female
Sandra	female
Burnaby	male
Kirstie	female
Randall	male
Ilka	female
Carey	male
Bab	female
Adelina	female
Dimitris	male
Alys	female
Herschel	male
Agnese	female
Valli	female
Leonerd	male
Sydney	male
Germain	female
Roda	female
Shelagh	female
Nonnah	female
Jeramie	male
Townie	male
Una	female
Kacey	female
Ulrika	female
Rakel	female
Celestia	female
Nathalia	female
Alvera	female
Spense	male
Nicky	female
Deva	female
Shirley	female
Abbie	female
Devin	male
Mari	female
Rodolph	male
Maggy	female
Ingrid	female
Adelind	female
Krystal	female
Patricia	female
Rozella	female
Jessi	female
Mervin	male
Heinrich	male
Maurie	male
Jeana	female
Viki	female
Mavis	female
Avrom	male
Silvanus	male
Lolande	female
Andie	female
Ardys	female
Emmye	female
Camile	female
Miquela	female
Ely	male
Chrystal	female
Marcus	male
Daphene	female
Friedrich	male
Dorelia	female
Gus	female
Jo-Anne	female
Dalila	female
Theodoric	male
Istvan	male
Hillel	male
Diahann	female
Robinia	female
Emilie	female
Nils	male
Ignacius	male
Alvira	female
Lon	male
Camala	female
Dinny	female
Kitty	female
Clarice	female
Raymundo	male
Bernette	female
Rhoda	female
Lillis	female
Donn	male
Aurel	female
Abbot	male
Venkat	male
Xenos	male
Bertie	female
Legra	female
Corinna	female
Sibel	female
Lillian	female
Simone	female
Adolphus	male
Winnah	female
Ingeberg	female
Xylina	female
Claudina	female
Annamarie	female
Harald	male
Cami	female
Donny	male
Gavin	male
Vallie	female
Jobyna	female
Dorise	female
Otto	male
Olle	male
Kiele	female
Kelcy	female
Nil	female
Aldwin	male
Ricardo	male
Woodie	male
Merwin	male
Christ	male
Jackquelin	female
Onida	female
Nollie	female
Edie	female
Dina	female
Charlene	female
Cassandre	female
Wilone	female
Ender	male
Agamemnon	male
Pearle	female
Woodman	male
Alejandro	male
Nichole	female
Hollie	female
Chandra	female
Cheslie	female
Zenia	female
Marielle	female
Kellina	female
Xymenes	male
Shelly	female
Eddi	female
Cleland	male
Georgianne	female
Ulises	male
Stefania	female
Josepha	female
Marabel	female
Maxim	male
Jolyn	female
Cayla	female
Ravi	male
Sisely	female
Merralee	female
Augustina	female
Nyssa	female
Derk	male
Lyndsay	female
Jackson	male
Danie	male
Marley	female
Viva	female
Alejandra	female
Myrtie	female
Carine	female
Guthrey	male
Erinna	female
Pam	female
Shir	female
Hanni	female
Baily	male
Hamel	male
Giovanne	male
Christos	male
Ralph	male
Joshuah	male
Audrey	female
Gerri	female
Toinette	female
Sterling	male
Rab	male
Petey	male
Darrin	male
Anatoly	male
Cliff	male
Bunnie	female
Glenine	female
Walther	male
Florette	female
Regan	male
Tobias	male
Rubi	female
Truman	male
Matti	female
Barby	female
Cybel	female
Sergeant	male
Trevor	male
Danika	female
Brita	female
Fred	male
Paulita	female
Rollo	male
Mason	male
Scottie	male
Suzie	female
Mozelle	female
Vivienne	female
Caryl	male
Lucian	male
Alexine	female
Hildegarde	female
Sasha	male
Verney	male
Silvester	male
Mitra	female
Bradford	male
Belvia	female
Rosita	female
Estrellita	female
Sonya	female
Hakeem	male
Raychel	female
Mary	female
Kendrick	male
Dorris	female
Eleanora	female
Nomi	female
Thaxter	male
Dwaine	male
Lorrie	male
Cal	female
Kourtney	female
Denis	male
Nertie	female
Angele	female
Skippy	male
Shane	female
Franky	male
Cassey	female
Tharen	male
Floris	female
Jenn	female
Emyle	female
Melina	female
Clare	male
Erik	male
Russel	male
Seamus	male
Caria	female
Chrissie	female
Ioana	female
Aurea	female
Noel	male
Roxy	female
Hagan	male
Warde	male
Hailee	female
Ingemar	male
Page	male
Moise	male
Kalie	female
Mortie	male
Wadsworth	male
Carrol	female
Joyous	female
Terra	female
Bertram	male
Marko	male
Chrystel	female
Angeline	female
Gabey	female
Feodora	female
Wendall	male
Renard	male
Zerk	male
Prescott	male
Dawn	female
Eileen	female
Georgie	female
Candy	female
Hortense	female
Mehetabel	female
Britt	male
Wye	male
Gwenni	female
Hill	male
Jehu	male
Barron	male
Florian	male
Chrissy	female
Benni	female
Karlene	female
Marijo	female
Prince	male
Leisha	female
Abby	female
Elianore	female
Garth	male
Kristy	female
Yolande	female
Shirline	female
Blaine	male
Millicent	male
Filmore	male
Jania	female
Lorilee	female
Rhona	female
Chriss	female
Tannie	male
Marlow	male
Pate	male
Letty	female
Filbert	male
Whit	male
Samuela	female
Christalle	female
Valentine	male
Briggs	male
Seymour	male
Felicle	female
Valerie	female
Aili	female
Costa	male
Cammi	female
Silvan	male
Bambie	female
Melisande	female
Timmy	female
Ferdy	male
Shepherd	male
Donal	male
Morris	male
Angel	female
Geoffrey	male
Uriah	male
Nanice	female
Christy	female
Missy	female
Olga	female
Sibeal	female
Kailey	female
Marcellina	female
Trudi	female
Mackenzie	male
Helaina	female
Christa	female
Roshelle	female
Sully	male
Batholomew	male
Arleyne	female
Christiano	male
Elisabetta	female
Prudence	female
Agata	female
Nelsen	male
Binny	female
Brigitte	female
Vance	male
Malanie	female
Norris	male
Jo	female
Berta	female
Jillie	female
Stanwood	male
Lockwood	male
Ripley	male
Kara	female
Armando	male
Archibald	male
Ailee	female
Dave	male
Francis	male
Jennings	male
Canada	female
Pacifica	female
Steffie	female
Constantin	male
Benson	male
Barrie	male
Goober	male
Glennis	female
Dacie	female
Stevana	female
Garrott	male
Kati	female
Jocelyne	female
Alwin	male
Tanya	female
Lindsay	female
Terrel	male
Star	female
Estel	female
Ramon	male
Maddy	female
Glenn	female
Sander	male
Ronnie	female
Mae	female
Carmelle	female
Celinda	female
Cindra	female
Flora	female
Magdalen	female
Fonz	male
Jackie	female
Roana	female
Carlota	female
Hanford	male
Stanton	male
Delly	female
Rosario	female
Alisun	female
Efram	male
Manuel	male
Barbra	female
Domenic	male
Edythe	female
Desdemona	female
Lyn	male
Tiphani	female
Cleva	female
Northrop	male
Averill	male
Nealson	male
Gilli	female
Bernetta	female
Dominique	female
Wiley	male
Jessalyn	female
Charlena	female
Amaleta	female
Diandra	female
Patsy	female
Jerrie	male
Sydney	female
Tobi	female
Yvonne	female
Haskel	male
Pat	female
Byron	male
Shalom	male
Homer	male
Rayshell	female
Dorette	female
Winny	male
Desiri	female
Rae	female
Geof	male
Rabi	male
Chrissa	female
Corie	female
Edeline	female
Pavla	female
See	male
Reeba	female
Jeffery	male
Janella	female
Goldia	female
Meg	female
Hershel	male
Laurette	female
Lamont	male
Charley	male
Hansel	male
Carline	female
Nat	female
Olivia	female
Zelma	female
Aretha	female
Caressa	female
Tommie	female
Cain	male
Nicolette	female
Shelden	male
Susette	female
Justis	male
Haydon	male
Nerta	female
Wallace	male
Vikki	female
Reina	female
Octavia	female
Hilary	male
Obadiah	male
Pepito	male
Stern	male
Deedee	female
Simona	female
Giralda	female
Terese	female
Rosalinde	female
Alidia	female
Ardith	female
Emmit	male
Rich	male
Lyndsey	female
Junia	female
Annora	female
Berty	female
Aviva	female
Ketty	female
Athene	female
Whitaker	male
Miranda	female
Rebbecca	female
Naomi	female
Debee	female
Sylvie	female
Ora	female
Kellsie	female
Adlai	male
Anissa	female
Anne-Corinne	female
Ranique	female
Charissa	female
Sam	male
Peirce	male
Nonna	female
Kaleb	male
Kally	female
Howard	male
Janette	female
Maryann	female
Diana	female
Katrinka	female
Idell	female
Wendy	female
Shalna	female
Abbi	female
Maris	female
Ward	male
Dennie	female
Nate	male
Cissy	female
Shorty	male
Abdullah	male
Quint	male
Elna	female
Ermengarde	female
Dion	female
Mauritz	male
Allyn	female
Nixie	female
Nelle	female
Gladys	female
Sheridan	male
Vernon	male
Melosa	female
Pia	female
Adolpho	male
Nora	female
Binni	female
Shandee	female
Agnola	female
Daveen	female
Jerrine	female
Xena	female
Ethel	female
Susannah	female
Davidde	male
Gabriele	male
Kit	male
Lilian	female
Fulton	male
Debra	female
Yoshi	female
Malorie	female
Raine	female
Merlin	male
Therese	female
Talyah	female
Casey	female
Benjie	male
Ansley	female
Rubina	female
Corena	female
Virgie	male
Alden	male
Hedy	female
Donovan	male
Aridatha	female
Aram	male
Gabbi	female
Eydie	female
Manish	male
Coletta	female
Gunner	male
Laurene	female
Nady	female
Andrea	female
Vania	female
Jaime	female
Gabriel	male
Ann-Mari	female
Albina	female
Gilberta	female
Tarah	female
Sonnie	male
Addie	female
Leann	female
Amadeus	male
Catha	female
Jodee	female
Barbara	female
Gussi	female
Bard	male
Jere	male
Rosette	female
Janis	female
Aphrodite	female
Magdaia	female
Carlen	female
Annice	female
Torrance	male
Jule	male
Flipper	male
Valida	female
Waneta	female
Dorita	female
Miguelita	female
Naoma	female
Morlee	female
Giuseppe	male
Neville	male
Bianca	female
Stearn	male
Fran	male
Viola	female
Tani	female
Ronna	female
Powell	male
Verna	female
Cybil	female
Irwin	male
Vasilis	male
Madel	female
Tabbitha	female
Buck	male
Loise	female
Tucky	male
Storey	female
Ajay	male
Ernest	male
Dido	female
Zebedee	male
Nessa	female
Orson	male
Dyana	female
Dehlia	female
Kitti	female
Jacklin	female
Dafna	female
Annetta	female
Anthia	female
Beverlie	female
Katha	female
Florri	female
Ninon	female
Judah	male
Silvain	male
Geoffry	male
Ave	male
Letisha	female
Laureen	female
Chelton	male
Upton	male
Sonja	female
Alicea	female
Brittney	female
Debi	female
Jordy	male
Marmaduke	male
Julia	female
Sue	female
Albert	male
Laraine	female
Fredia	female
Chery	female
Marlane	female
Rey	female
Eloise	female
Ginger	male
Stillman	male
Cordy	female
Christian	male
Gerrit	male
Justine	female
Jose	male
Klaus	male
Alfie	female
Tamas	male
Tuesday	female
Danni	female
Elfrieda	female
Seka	female
Max	female
Lonnie	male
Lara	female
Wilbert	male
Selena	female
Britta	female
Gael	female
Cole	male
Corrianne	female
Wayland	male
Thaine	male
Tadeas	male
Fayina	female
Blakelee	female
Charleen	female
Niccolo	male
Quinlan	male
Gloria	female
Freddy	male
Moya	female
Jayne	female
Helge	female
Lizabeth	female
Valaria	female
Serene	female
Leesa	female
Traver	male
Kala	female
Tirrell	male
Paula	female
Esteban	male
Oona	female
Patrizia	female
Jeni	female
Athena	female
Britt	female
Damian	male
Alia	female
Ilysa	female
Inna	female
Godart	male
Anatollo	male
Glori	female
Antonietta	female
Joel	male
Micheline	female
Rea	female
Odin	male
Elyse	female
Guido	male
Gray	female
Von	male
Mirna	female
Devan	female
Sayre	female
Beulah	female
Grant	male
Emmalynn	female
Inessa	female
Hugo	male
Devin	female
Natty	female
Oberon	male
Sheldon	male
Mabelle	female
Freida	female
Leonard	male
Romain	male
Lolita	female
Guillemette	female
Lazlo	male
Tobin	male
Ninetta	female
Cathyleen	female
Annabela	female
Jerald	male
Neila	female
Emmi	female
Jorie	female
Uta	female
Perle	female
Carley	female
Aldis	male
Leonardo	male
Tabbi	female
Abagael	female
Kristos	male
Lindsy	female
Shanan	male
Sascha	male
Randi	female
Reiko	female
Jazmin	female
Lois	female
Sadie	female
Wilber	male
Margeaux	female
Ferne	female
Wilona	female
Finn	male
Paola	female
Jean-Lou	male
Jessa	female
Taddeo	male
Twyla	female
Braden	male
Teane	female
Timothee	male
Tomas	male
Vanni	female
Danya	female
Charlie	male
Marglerite	female
Glen	female
Brady	male
Thom	male
Lucita	female
Rob	male
Jay	male
Annette	female
Emmey	female
Cicily	female
Sayer	male
Heloise	female
Luna	female
Thomasa	female
Leonore	female
Dedra	female
Cilka	female
Daveta	female
Graehme	male
Shem	male
Malka	female
Leonhard	male
Caron	female
Sawyer	male
Donnamarie	female
Jed	male
Carolan	female
Isis	female
Sebastien	male
Donia	female
Tudor	male
Tallie	male
Christophe	male
Estele	female
Vergil	male
Deirdre	female
Ninette	female
Jean-Marc	male
Mohammad	male
Dori	female
Parry	male
Priscilla	female
Roseline	female
Trina	female
Zippy	male
Kat	female
Alvin	male
Elnora	female
Joanna	female
Wilfrid	male
Kristan	female
Alanna	female
Berkley	male
Lawton	male
Tobe	female
Robby	female
Terrell	male
Dolli	female
Thomasin	female
Honor	female
Theo	male
Anabel	female
Eugenia	female
Nicolea	female
Bettina	female
Ardeen	female
Auroora	female
Vick	male
Emiline	female
Loralie	female
Claudio	male
Laurice	female
Lavinie	female
King	male
Tessy	female
Hassan	male
Sindee	female
Reggis	male
Valene	female
Nelly	female
Llewellyn	male
Tyrus	male
Deane	female
Barbie	female
Lemmy	male
Irvine	male
Rani	female
Garnette	female
Hamlen	male
Pammie	female
Reed	male
Reine	female
Bailie	male
Loleta	female
Karry	female
Zarah	female
Annalee	female
Paten	male
Veronique	female
Kamilah	female
Marrissa	female
Faye	female
Yance	male
Rosetta	female
Cory	male
Talya	female
Noam	male
Torre	male
Farah	female
Easter	female
Sarena	female
Riccardo	male
Lurline	female
Marsiella	female
Myrle	female
Red	male
Jenica	female
Beaufort	male
Kacie	female
Hervey	male
Adolfo	male
Lucina	female
Alister	male
Evaleen	female
Callie	female
Raven	female
Urson	male
Lilyan	female
Damon	male
Chloris	female
Saul	male
Pierrette	female
Olympia	female
Gavrielle	female
Cortney	female
Zorana	female
# List of common male names.	male
Rodina	female
Melicent	female
Pandora	female
Socrates	male
Tallie	female
Sheree	female
Elizabet	female
Marcie	female
Sullivan	male
Eveline	female
Shanda	female
Madge	female
Tera	female
Darcy	male
Tella	female
Neil	male
Lance	male
Ambrosia	female
Paulette	female
Nelson	male
Niki	male
Edmond	male
Kathleen	female
Caro	female
Bertie	male
Jacquelyn	female
Adrian	male
Churchill	male
Cherin	female
Leland	male
Almeda	female
Beverlee	female
Gwenore	female
Modesty	female
Madella	female
Sara	female
Inglebert	male
Alfonso	male
Hewitt	male
Elsbeth	female
Merla	female
Gwyn	female
Nydia	female
Brewster	male
Vikkie	female
Werner	male
Joella	female
Anetta	female
Winfred	male
Luciano	male
Allyson	female
Marjie	female
Devon	male
Britaney	female
Merl	female
Jeb	male
Adrick	male
Ivie	female
Gabrila	female
Hayes	male
Revkah	female
Petronella	female
Toby	female
Clinton	male
Spiro	male
Ignatius	male
Katine	female
Minette	female
Briteny	female
Quincey	male
Jeralee	female
Atlante	female
Hamlin	male
Frederik	male
Yaakov	male
Ware	male
Doyle	male
Kora	female
Kari	female
Che	male
Milicent	female
Rudy	male
Skell	male
Petr	male
Carmelita	female
Raymond	male
Willie	male
Julianne	female
Fonzie	male
Modestine	female
Maxy	female
Nona	female
Derick	male
Ozzy	male
Rem	male
Sarene	female
Vicky	female
Agatha	female
Zollie	male
Alana	female
Kellen	male
Willis	male
Lyle	male
Srinivas	male
Marit	female
Deena	female
Paule	female
Karole	female
Nevile	male
Beatrix	female
Solange	female
Er	male
Arvie	male
Thomasine	female
Gearard	male
Wildon	male
Sybil	female
Maire	female
Putnam	male
Mikako	female
Peria	female
Henrie	female
Wright	male
Evangelia	female
Eirena	female
Jessey	male
Drea	female
Sonnie	female
Taite	male
Joletta	female
Herrmann	male
Sandy	male
Marlo	male
Franciska	female
Philly	female
Meade	female
Venus	female
Marti	female
Shea	male
Florance	female
Mac	male
Dimitry	male
Wash	male
Juli	female
Brigit	female
Sutherland	male
Willi	female
Nikolia	female
Brent	male
Leanor	female
Sanford	male
Olaf	male
Suzanna	female
Alexei	male
Kaile	female
Hannah	female
Tandy	female
Valery	female
Bernie	male
Corrinne	female
Silas	male
Darda	female
Jehanna	female
Georgeanna	female
Karsten	male
Herby	male
LeeAnn	female
Dalenna	female
Markus	male
Britte	female
Koressa	female
Sheela	female
Doralynn	female
Jarrett	male
Cassy	female
Darcey	female
Kara-Lynn	female
Moshe	male
Thorn	male
Lelah	female
Aharon	male
Benjamen	male
Lotty	female
Stearne	male
Gavra	female
Cass	female
Gershom	male
Vilhelmina	female
Gennifer	female
Dulcia	female
Bernhard	male
Mitchel	male
Mickie	female
Petronilla	female
Dara	female
Andromache	female
Eartha	female
Thadeus	male
Eadie	female
May	female
Gipsy	female
Smith	male
Irita	female
Lind	female
Marita	female
Susana	female
Daile	female
Marylynne	female
Pierette	female
Filia	female
Rivkah	female
Hana	female
Flem	male
Camellia	female
Shirah	female
Leif	male
Lazaro	male
Hunter	male
Tina	female
Hamnet	male
Kerry	female
Ara	female
Dasya	female
